baa N: baas
baa V: baaed  baaing  baas
babble N: ~babbles
babble V: babbled  babbling  babbles
babbler N: babblers
babe N: babes
babel N: babels
baboon N: baboons
babushka N: babushkas
baby A: babier  babiest
baby N: babies
baby V: babied  babying  babies
babyhood N: ~babyhoods
babyish A:
babysit V: babysit  babysat  babysitting  babysits
babysitter N: babysitters
babysitting N: ~babysittings
baccalaureate N: baccalaureates
baccarat N: ~baccarats
bacchanal A:
bacchanal N: bacchanals
bacchanalia N: bacchanalia (bacchanalias)
bacchanalian A:
bacchanalian N: bacchanalians
bachelor N: bachelors
bachelorhood N: ~bachelorhoods
bacillary A:
bacillus N: bacilli
back A:
back N: backs
back V: backed  backing  backs
backache N: backaches
backbencher N: backbenchers
backbite V: backbit  backbitten  backbiting  backbites
backbiter N: backbiters
backboard N: backboards
backbone N: backbones
backbreaking A:
backdate V: backdated  backdating  backdates
backdrop N: backdrops
-backdrop V: backdropped  backdropping  backdrops
backer N: backers
backfield N: backfields
backfire N: backfires
backfire V: backfired  backfiring  backfires
backgammon N: ~backgammons
-backgammon V: backgammoned  backgammoning  backgammons
background A:
background N: backgrounds
-background V: backgrounded  backgrounding  backgrounds
backgrounder N: backgrounders
backhand A:
backhand N: backhands
backhand V: backhanded  backhanding  backhands
backhandedly A:
backhander N: backhanders
backhoe N: backhoes
backing N: backings
backlash N: backlashes
-backlash V: backlashed  backlashing  backlashes
backless A:
backlog N: backlogs
backlog V: backlogged  backlogging  backlogs
backpack N: backpacks
backpack V: backpacked  backpacking  backpacks
backpacker N: backpackers
backpacking N: ~backpackings
backpedal V: backpedaled (backpedalled)  backpedaling (backpedalling)  backpedals
backrest N: backrests
backroom A:
backscratching N: ~backscratchings
backseat N: backseats
backside N: backsides
backslapper N: backslappers
backslapping N: ~backslappings
backslash N: backslashes
backslide V: backslid  backslid (backslidden)  backsliding  backslides
backslider N: backsliders
backspace N: backspaces
backspace V: backspaced  backspacing  backspaces
backspin N: ~backspins
backstabber N: backstabbers
backstage A:
backstage N: ~backstages
backstair A:
backstairs A:
backstop N: backstops
backstop V: backstopped  backstopping  backstops
backstretch N: backstretches
backstroke N: backstrokes
backstroke V: backstroked  backstroking  backstrokes
backtalk N: ~backtalks
backtrack V: backtracked  backtracking  backtracks
backup A:
backup N: backups
backward A:
backwardly A:
backwardness N: ~backwardnesses
backwards A:
backwash N: ~backwashes
-backwash V: backwashed  backwashing  backwashes
backwater N: backwaters
backwoods A:
backwoods N:
backwoodsman N: backwoodsmen
backyard N: backyards
bacon N: ~bacons
bacteria N: - (-bacterias)
bacterial A:
bactericidal A:
bactericide N: bactericides
bacteriologic A:
bacteriological A:
bacteriologist N: bacteriologists
bacteriology N: ~bacteriologies
bacterium N: bacteria
bad A {slang}: badder  baddest
bad A: worse  worst
bad N: ~bads
baddie N: baddies
baddy N: baddies
badge N: badges
-badge V: badged  badging  badges
badger N: badgers
badger V: badgered  badgering  badgers
badinage N: ~badinages
-badinage V: badinaged  badinaging  badinages
badlands N:
badly A:
badman N: badmen
badminton N: ~badmintons
badmouth V: badmouthed  badmouthing  badmouths
badness N: ~badnesses
baffle N: baffles
baffle V: baffled  baffling  baffles
bafflement N: ~bafflements
baffler N: bafflers
bag N: bags
bag V: bagged  bagging  bags
bagatelle N: bagatelles
bagel N: bagels
bagful N: bagfuls (bagsful)
baggage N: ~baggages
baggie N: baggies
baggily A:
bagginess N: ~bagginesses
baggy A: baggier  baggiest
bagpipe A:
bagpipe N: bagpipes
-bagpipe V: bagpiped  bagpiping  bagpipes
bagpiper N: bagpipers
baguette N: baguettes
bah I:
baht N: bahts
bail N: bails
bail V: bailed  bailing  bails
bailable A:
xbailiff N: bailiffs
bailiwick N: bailiwicks
-bailout A:
bailout N: bailouts
bailsman N: bailsmen
bairn N: bairns
bait N: ~baits
bait V: baited  baiting  baits
baize N: ~baizes
-baize V: baized  baizing  baizes
bake N: bakes
bake V: baked  baking  bakes
baker N: bakers
bakery N: bakeries
bakeshop N: bakeshops
baklava N: ~baklavas
baksheesh N: ~baksheeshes
-baksheesh V: baksheeshed  baksheeshing  baksheeshes
balaclava N: balaclavas
balalaika N: balalaikas
balance N: balances
balance V: balanced  balancing  balances
balboa N: balboas
balcony N: balconies
bald A: balder  baldest
bald V: balded  balding  balds
balderdash N: ~balderdashes
baldfaced A:
baldly A:
baldness N: ~baldnesses
baldric N: baldrics
bale N: bales
bale V: baled  baling  bales
baleen N: ~baleens
baleful A: -balefuller  -balefullest
balefully A:
balefulness N: ~balefulnesses
baler N: balers
balk N: balks
balk V: balked  balking  balks
balky A: balkier  balkiest
ball N: balls
ball V: balled  balling  balls
ballad N: ballads
balladeer N: balladeers
balladry N: ~balladries
ballast N: ~ballasts
ballast V: ballasted  ballasting  ballasts
ballcock N: ballcocks
ballerina N: ballerinas
ballet N: ballets
balletic A:
ballgame N: ballgames
ballistic A:
ballistics N:
balloon A:
balloon N: balloons
balloon V: ballooned  ballooning  balloons
balloonist N: balloonists
ballot N: ballots
ballot V: balloted  balloting  ballots
ballpark N: ballparks
ballplayer N: ballplayers
ballpoint N: ballpoints
ballroom N: ballrooms
ballsy A: ballsier  ballsiest
ballyhoo N: ~ballyhoos
ballyhoo V: ballyhooed  ballyhooing  ballyhoos
balm N: balms
balminess N: ~balminesses
balmy A: balmier  balmiest
baloney N: ~baloneys
balsa N: balsas
balsam N: balsams
balsamic A:
baluster N: balusters
balustrade N: balustrades
bamboo A:
bamboo N: bamboos
bamboozle V: bamboozled  bamboozling  bamboozles
ban N: bans {prohibition} | bani {money}
ban V: banned  banning  bans
banal A: -banaler  -banalest
banality N: banalities
banally A:
banana N: bananas
band N: bands
band V: banded  banding  bands
bandage N: bandages
bandage V: bandaged  bandaging  bandages
bandana N: bandanas
bandanna N: bandannas
bandbox N: bandboxes
bandeau N: bandeaux
bandit N: bandits (banditti)
banditry N: ~banditries
bandmaster N: bandmasters
bandoleer N: bandoleers
bandolier N: bandoliers
bandsman N: bandsmen
bandstand N: bandstands
bandwagon N: bandwagons
bandy A: bandier  bandiest
-bandy N: bandies
bandy V: bandied  bandying  bandies
bane N: banes
baneful A: -banefuller  -banefullest
bang A:
bang I:
bang N: bangs
bang V: banged  banging  bangs
bangle N: bangles
banish V: banished  banishing  banishes
banishment N: ~banishments
banister N: banisters
banjo N: banjos (banjoes)
banjoist N: banjoists
bank N: banks
bank V: banked  banking  banks
bankable A:
bankbook N: bankbooks
bankcard N: bankcards
banker N: bankers
banking N: ~bankings
banknote N: banknotes
bankroll N: bankrolls
bankroll V: bankrolled  bankrolling  bankrolls
bankrupt A:
bankrupt N: bankrupts
bankrupt V: bankrupted  bankrupting  bankrupts
bankruptcy N: bankruptcies
banner A:
banner N: banners
bannister N: bannisters
bannock N: bannocks
banns N:
banquet N: banquets
banquet V: banqueted  banqueting  banquets
banqueter N: banqueters
banquette N: banquettes
banshee N: banshees
banshie N: banshies
bantam A:
bantam N: bantams
bantamweight N: bantamweights
banter N: ~banters
banter V: bantered  bantering  banters
banteringly A:
banyan N: banyans
banzai N: banzais
baobab N: baobabs
baptism N: baptisms
baptismal A:
baptistery N: baptisteries
baptistry N: baptistries
baptize V: baptized  baptizing  baptizes
baptizer N: baptizers
bar C:
bar N: bars
bar V: barred  barring  bars
barb N: barbs
barb V: barbed  barbing  barbs
barbarian A:
barbarian N: barbarians
barbarianism N: barbarianisms
barbaric A:
barbarically A:
barbarism N: barbarisms
barbarity N: barbarities
barbarize V: barbarized  barbarizing  barbarizes
barbarous A:
barbarously A:
barbecue N: barbecues
barbecue V: barbecued  barbecuing  barbecues
barbel N: barbels
barbell N: barbells
barbeque N: barbeques
barbeque V: barbequed  barbequing  barbeques
barber N: barbers
barber V: barbered  barbering  barbers
barberry N: barberries
barbershop N: barbershops
barbiturate N: barbiturates
barbwire N: ~barbwires
barcarole N: barcaroles
barcarolle N: barcarolles
bard N: bards
-bard V: barded  barding  bards
bardic A:
bare A: barer  barest
bare V: bared  baring  bares
bareback A:
barebacked A:
barefaced A:
barefacedly A:
barefoot A:
barefooted A:
barehanded A:
bareheaded A:
barelegged A:
barely A:
bareness N: ~barenesses
barf N: ~barfs
barf V: barfed  barfing  barfs
barfly A:
barfly N: barflies
bargain N: bargains
bargain V: bargained  bargaining  bargains
bargainer N: bargainers
barge N: barges
barge V: barged  barging  barges
bargeman N: bargemen
barhop V: barhopped  barhopping  barhops
baritone A:
baritone N: baritones
barium N: ~bariums
bark N: barks
bark V: barked  barking  barks
barkeep N: barkeeps
barkeeper N: barkeepers
barker N: barkers
barley N: ~barleys
barmaid N: barmaids
barman N: barmen
barn N: barns
-barn V: barned  barning  barns
barnacle N: barnacles
barnacled A:
barnstorm V: barnstormed  barnstorming  barnstorms
barnstormer N: barnstormers
barnyard A:
barnyard N: barnyards
barometer N: barometers
barometric A:
barometrically A:
baron N: barons
baronage N: baronages
baroness N: baronesses
baronet N: baronets
baronetcy N: baronetcies
baronial A:
barony N: baronies
baroque A:
baroque N: ~baroques
barque N: barques
barrack N: barracks
barrack V: barracked  barracking  barracks
barracuda N: barracudas | barracuda
barrage N: barrages
barrage V: barraged  barraging  barrages
barre N: barres
barrel N: barrels
barrel V: barreled (barrelled)  barreling (barrelling)  barrels
barren A: barrener  barrenest
barren N: barrens
barrenness N: ~barrennesses
barrette N: barrettes
barricade N: barricades
barricade V: barricaded  barricading  barricades
barrier N: barriers
barring C:
barrio N: barrios
barrister N: barristers
barroom N: barrooms
barrow N: barrows
bartender N: bartenders
barter N: ~barters
barter V: bartered  bartering  barters
barterer N: barterers
baryon N: baryons
basal A:
basally A:
basalt N: ~basalts
basaltic A:
base A: baser  basest
base N: bases
base V: based  basing  bases
baseball N: baseballs
baseboard N: baseboards
baseless A:
baseline N: baselines
basely A:
baseman N: basemen
basement N: basements
baseness N: ~basenesses
bash N: bashes
bash V: bashed  bashing  bashes
bashful A:
bashfully A:
bashfulness N: ~bashfulnesses
bashing N: ~bashings
basic A:
basic N: basics
basically A:
basil N: ~basils
basilica N: basilicas
basilisk N: basilisks
basin N: basins
basinful N: basinfuls
basis N: bases
bask V: basked  basking  basks
basket N: baskets
basketball N: basketballs
basketry N: ~basketries
basketwork N: ~basketworks
bass A: -basser  -bassest
bass N {fish}: bass | basses
bass N {voice}: basses
basset N: bassets
-basset V: basseted  basseting  bassets
bassinet N: bassinets
bassist N: bassists
basso N: bassos (bassi)
bassoon N: bassoons
bassoonist N: bassoonists
basswood N: basswoods
bast N: ~basts
bastard A:
bastard N: bastards
bastardization N: bastardizations
bastardize V: bastardized  bastardizing  bastardizes
bastardy N: ~bastardies
-baste N: bastes
baste V: basted  basting  bastes
baster N: basters
bastion N: bastions
bat N: bats
bat V: batted  batting  bats
batch N: batches
batch V: batched  batching  batches
-bate N: bates
bate V: bated  bating  bates
bath N: baths
-bath V: bathed  bathing  baths
bathe N: bathes
bathe V: bathed  bathing  bathes
bather N: bathers
bathetic A:
bathhouse N: bathhouses
bathing N: ~bathings
bathmat N: bathmats
bathos N: ~bathoses
bathrobe N: bathrobes
bathroom N: bathrooms
bathtub N: bathtubs
bathyscaph N: bathyscaphs
bathyscaphe N: bathyscaphes
bathysphere N: bathyspheres
batik N: batiks
-batik V: batiked  batiking  batiks
batiste N: ~batistes
batman N: batmen
baton N: batons
batsman N: batsmen
battalion N: battalions
batten N: battens
batten V: battened  battening  battens
batter N: batters
batter V: battered  battering  batters
batterer N: batterers
battery N: batteries
batting N: ~battings
battle N: battles
battle V: battled  battling  battles
battleax N: battleaxes
battleaxe N: battleaxes
battledore N: battledores
-battledore V: battledored  battledoring  battledores
battlefield N: battlefields
battlefront N: battlefronts
battleground N: battlegrounds
battlement N: battlements
battler N: battlers
battleship N: battleships
batty A: battier  battiest
bauble N: baubles
baud N: baud (bauds)
baulk N: baulks
baulk V: baulked  baulking  baulks
bauxite N: ~bauxites
bawd N: bawds
bawdily A:
bawdiness N: ~bawdinesses
bawdy A: bawdier  bawdiest
-bawdy N: bawdies
bawl N: bawls
bawl V: bawled  bawling  bawls
bay A:
bay N: bays
bay V: bayed  baying  bays
bayberry N: bayberries
bayonet N: bayonets
bayonet V: bayoneted (bayonetted)  bayoneting (bayonetting)  bayonets
bayou N: bayous
bazaar N: bazaars
bazooka N: bazookas
be V:     
beach N: beaches
beach V: beached  beaching  beaches
beachcomber N: beachcombers
beachhead N: beachheads
beachwear N: ~beachwears
beacon N: beacons
-beacon V: beaconed  beaconing  beacons
bead N: beads
bead V: beaded  beading  beads
beading N: ~beadings
beadle N: beadles
beady A: beadier  beadiest
beagle N: beagles
beak N: beaks
beaked A:
beaker N: beakers
beam N: beams
beam V: beamed  beaming  beams
bean N: beans
bean V: beaned  beaning  beans
beanbag N: beanbags
beanie N: beanies
beanpole N: beanpoles
beanstalk N: beanstalks
bear N: bears | bear
bear V: bore  borne (born)  bearing  bears
bearable A:
bearably A:
beard N: beards
beard V: bearded  bearding  beards
bearded A:
beardless A:
bearer N: bearers
bearing N: bearings
bearish A:
bearishly A:
bearishness N: ~bearishnesses
bearlike A:
bearskin N: bearskins
beast N: beasts
beastliness N: ~beastlinesses
beastly A: beastlier  beastliest
beastly N:
beat A:
beat N: beats
beat V: beat  beaten (beat)  beating  beats
beatable A:
beater N: beaters
beatific A:
beatifically A:
beatification N: beatifications
beatify V: beatified  beatifying  beatifies
beating N: beatings
beatitude N: beatitudes
beatnik N: beatniks
beau N: beaus / beaux
-beau V: beaued  beauing  beaus
beaut A:
beaut N: beauts
beauteous A:
beauteously A:
beautician N: beauticians
beautification N: ~beautifications
beautifier N: beautifiers
beautiful A: -beautifuler  -beautifulest
beautifully A:
beautify V: beautified  beautifying  beautifies
beauty N: beauties
beaver N: beavers | beaver
beaver V: beavered  beavering  beavers
bebop N: ~bebops
becalm V: becalmed  becalming  becalms
because C:
beck N: becks
-beck V: becked  becking  becks
-beckon N: beckons
beckon V: beckoned  beckoning  beckons
becloud V: beclouded  beclouding  beclouds
become V: became  become  becoming  becomes
becomingly A:
bed N: beds
bed V: bedded  bedding  beds
bedaub V: bedaubed  bedaubing  bedaubs
bedazzle V: bedazzled  bedazzling  bedazzles
bedazzlement N: ~bedazzlements
bedbug N: bedbugs
bedclothes N:
bedding N: ~beddings
bedeck V: bedecked  bedecking  bedecks
bedevil V: bedeviled (bedevilled)  bedeviling (bedevilling)  bedevils
bedevilment N: ~bedevilments
bedfellow N: bedfellows
bedim V: bedimmed  bedimming  bedims
bedizen V: bedizened  bedizening  bedizens
bedlam N: bedlams
bedpan N: bedpans
bedpost N: bedposts
bedraggle V: bedraggled  bedraggling  bedraggles
bedridden A:
bedrock A:
bedrock N: bedrocks
bedroll N: bedrolls
bedroom A:
bedroom N: bedrooms
bedside A:
bedside N: bedsides
bedsore N: bedsores
bedspread N: bedspreads
bedstead N: bedsteads
bedtime N: bedtimes
bee N: bees
beebread N: ~beebreads
beech N: beeches
beechnut N: beechnuts
beef N: beeves {animal} | beefs {complaint}
beef V: beefed  beefing  beefs
beefburger N: beefburgers
beefcake N: beefcakes
beefiness N: ~beefinesses
beefsteak N: beefsteaks
beefy A: beefier  beefiest
beehive N: beehives
beekeeper N: beekeepers
beekeeping N: ~beekeepings
beeline N: beelines
been V: 
beep N: beeps
beep V: beeped  beeping  beeps
beeper N: beepers
beer N: beers
beery A: beerier  beeriest
beeswax N: ~beeswaxes
-beeswax V: beeswaxed  beeswaxing  beeswaxes
beet N: beets
beetle A:
beetle N: beetles
beetle V: beetled  beetling  beetles
befall V: befell  befallen  befalling  befalls
befit V: befitted  befitting  befits
befittingly A:
befog V: befogged  befogging  befogs
before A:
before C:
beforehand A:
befoul V: befouled  befouling  befouls
befriend V: befriended  befriending  befriends
befuddle V: befuddled  befuddling  befuddles
befuddlement N: ~befuddlements
-beg N: begs
beg V: begged  begging  begs
beget V: begot (@begat)  begotten (begot)  begetting  begets
beggar N: beggars
beggar V: beggared  beggaring  beggars
beggarly A:
beggary N: ~beggaries
begin V: began  begun  beginning  begins
beginner N: beginners
beginning N: beginnings
begone V:
begonia N: begonias
begrime V: begrimed  begriming  begrimes
begrudge V: begrudged  begrudging  begrudges
begrudgingly A:
beguile V: beguiled  beguiling  beguiles
beguilement N: ~beguilements
beguiler N: beguilers
beguilingly A:
beguine N: beguines
begum N: begums
-begum V: begummed  begumming  begums
behalf N: behalves
behave V: behaved  behaving  behaves
behavior N: ~behaviors
behavioral A:
behaviorally A:
behaviorism N: ~behaviorisms
behaviorist N: behaviorists
behaviour N: ~behaviours
behead V: beheaded  beheading  beheads
behemoth N: behemoths
behest N: behests
behind A:
behind C:
behind N: behinds
behindhand A:
behold V: beheld  beholding  beholds
beholden A:
beholder N: beholders
behoove V: behooved  behooving  behooves
beige A:
beige N: ~beiges
being V: 
bejewel V: bejewelled (bejeweled)  bejewelling (bejeweling)  bejewels
belabor V: belabored  belaboring  belabors
belabour V: belaboured  belabouring  belabours
belated A:
belatedly A:
-belay N: belays
belay V: belayed  belaying  belays
belch N: belches
belch V: belched  belching  belches
beleaguer V: beleaguered  beleaguering  beleaguers
belfry N: belfries
belie V: belied  belying  belies
belief N: beliefs
believable A:
believably A:
believe V: believed  believing  believes
believer N: believers
belittle V: belittled  belittling  belittles
belittlement N: ~belittlements
bell N: bells
bell V: belled  belling  bells
belladonna N: ~belladonnas
bellboy N: bellboys
belle N: belles
belletrist N: belletrists
belletristic A:
bellhop N: bellhops
bellicose A:
bellicosity N: ~bellicosities
belligerence N: ~belligerences
belligerency N: ~belligerencies
belligerent A:
belligerent N: belligerents
belligerently A:
bellman N: bellmen
bellow N: bellows
bellow V: bellowed  bellowing  bellows
bellwether N: bellwethers
belly N: bellies
belly V: bellied  bellying  bellies
bellyache N: bellyaches
bellyache V: bellyached  bellyaching  bellyaches
bellybutton N: bellybuttons
bellyful N: bellyfuls
belong V: belonged  belonging  belongs
belonging N: belongings
beloved N: beloveds
below A:
below C:
belt N: belts
belt V: belted  belting  belts
beltway N: beltways
beluga N: belugas | beluga
bemire V: bemired  bemiring  bemires
bemoan V: bemoaned  bemoaning  bemoans
bemuse V: bemused  bemusing  bemuses
bemusedly A:
bemusement N: ~bemusements
bench N: benches
bench V: benched  benching  benches
benchmark N: benchmarks
-benchmark V: benchmarked  benchmarking  benchmarks
bend N: bends
bend V: bent  bending  bends
bendable A:
bender N: benders
beneath A:
beneath C:
benediction N: benedictions
benedictory A:
benefaction N: benefactions
benefactor N: benefactors
benefactress N: benefactresses
benefice N: benefices
-benefice V: beneficed  beneficing  benefices
beneficence N: ~beneficences
beneficent A:
beneficently A:
beneficial A:
beneficially A:
beneficiary A:
beneficiary N: beneficiaries
benefit N: benefits
benefit V: benefited (benefitted)  benefiting (benefitting)  benefits
benevolence N: benevolences
benevolent A:
benevolently A:
benighted A:
benightedly A:
benign A: benigner  benignest
benignant A:
benignity N: ~benignities
benignly A:
bent N: bents
bentwood A:
bentwood N: ~bentwoods
benumb V: benumbed  benumbing  benumbs
benzene N: ~benzenes
benzine N: ~benzines
bequeath V: bequeathed  bequeathing  bequeaths
bequest N: bequests
berate V: berated  berating  berates
bereave V: bereaved (bereft)  bereaving  bereaves
bereavement N: bereavements
beret N: berets
berg N: bergs
beriberi N: ~beriberis
berkelium N: ~berkeliums
berm N: berms
berry N: berries
berry V: berried  berrying  berries
berrylike A:
berserk A:
-berserk N: berserks
berth N: berths
berth V: berthed  berthing  berths
beryl N: beryls
beryllium N: ~berylliums
beseech V: besought (beseeched)  beseeching  beseeches
beseecher N: beseechers
beseechingly A:
beseem V: beseemed  beseeming  beseems
beset V: beset  besetting  besets
beside A:
beside C:
besides A:
besides C:
besiege V: besieged  besieging  besieges
besieger N: besiegers
besmear V: besmeared  besmearing  besmears
besmirch V: besmirched  besmirching  besmirches
besom N: besoms
besot V: besotted  besotting  besots
bespangle V: bespangled  bespangling  bespangles
bespatter V: bespattered  bespattering  bespatters
bespeak V: bespoke  bespoken  bespeaking  bespeaks
bespectacled A:
best A:
best N: bests
best V: bested  besting  bests
bestial A:
bestiality N: ~bestialities
bestially A:
bestiary N: bestiaries
bestir V: bestirred  bestirring  bestirs
bestow V: bestowed  bestowing  bestows
bestowal N: bestowals
bestrew V: bestrewed  bestrewed (bestrewn)  bestrewing  bestrews
bestride V: bestrode (bestrid)  bestridden (bestrid)  bestriding  bestrides
bestseller N: bestsellers
bet N: bets
bet V: bet (betted)  betting  bets
beta N: betas
betake V: betook  betaken  betaking  betakes
betcha S:
betel N: ~betels
bethink V: bethought  bethinking  bethinks
betide V: betided  betiding  betides
betimes A:
betoken V: betokened  betokening  betokens
betray V: betrayed  betraying  betrays
betrayal N: betrayals
betrayer N: betrayers
betroth V: betrothed  betrothing  betroths
betrothal N: betrothals
betrothed N: betrothed (-betrotheds)
better A:
better N: betters
better V: bettered  bettering  betters
betterment N: ~betterments
bettor N: bettors
between A:
between C:
-between N: betweens
betwixt A:
bevel A:
bevel N: bevels
bevel V: beveled (bevelled)  beveling (bevelling)  bevels
beverage N: beverages
bevy N: bevies
bewail V: bewailed  bewailing  bewails
beware V: bewared  bewaring  bewares
bewhiskered A:
bewigged A:
bewilder V: bewildered  bewildering  bewilders
bewilderingly A:
bewilderment N: ~bewilderments
bewitch V: bewitched  bewitching  bewitches
bewitchingly A:
bewitchment N: ~bewitchments
bey N: beys
beyond A:
beyond C:
bezel N: bezels
bi A:
bi N: bis
biannual A:
biannually A:
bias A:
bias N: biases
bias V: biased (biassed)  biasing (biassing)  biases (-biasses)
biathlon N: biathlons
bib N: bibs
-bib V: bibbed  bibbing  bibs
bible N: bibles
biblical A:
bibliographer N: bibliographers
bibliographic A:
bibliographical A:
bibliographically A:
bibliography N: bibliographies
bibliophile N: bibliophiles
bibulous A:
bicameral A:
bicameralism N: ~bicameralisms
bicarb N: bicarbs
bicarbonate N: bicarbonates
bicentenary A:
bicentenary N: bicentenaries
bicentennial A:
bicentennial N: bicentennials
bicep N: biceps
biceps N: biceps (bicepses)
bicker N: bickers
bicker V: bickered  bickering  bickers
bickerer N: bickerers
biconcave A:
biconvex A:
bicuspid A:
bicuspid N: bicuspids
bicycle N: bicycles
bicycle V: bicycled  bicycling  bicycles
bicycler N: bicyclers
bicyclist N: bicyclists
bid N: bids
bid V {command}: bade  bidden  bidding  bids
bid V {offer}: bid  bidding  bids
biddable A:
bidder N: bidders
bidding N: ~biddings
biddy N: biddies
bide V: bode (bided)  biding  bides
bidet N: bidets
bidirectional A:
bidirectionally A:
biennial A:
biennial N: biennials
biennially A:
biennium N: bienniums (biennia)
bier N: biers
bifocal A:
bifocals N:
bifurcate A:
bifurcate V: bifurcated  bifurcating  bifurcates
bifurcation N: bifurcations
big A: bigger  biggest
-big V: bigged  bigging  bigs
bigamist N: bigamists
bigamous A:
bigamy N: ~bigamies
biggie N: biggies
biggish A:
bighead N: bigheads
bighearted A:
bigheartedness N: ~bigheartednesses
bighorn N: bighorns | bighorn
bight N: bights
-bight V: bighted  bighting  bights
bigmouth N: bigmouths
bigness N: ~bignesses
bigot N: bigots
bigoted A:
bigotry N: bigotries
bigwig N: bigwigs
bijou A:
bijou N: bijoux
bike N: bikes
bike V: biked  biking  bikes
biker N: bikers
bikini N: bikinis
bilabial A:
bilabial N: bilabials
bilateral A:
bilaterally A:
bile N: ~biles
bilge N: bilges
-bilge V: bilged  bilging  bilges
bilingual A:
bilingual N: bilinguals
bilingualism N: ~bilingualisms
bilingually A:
bilious A:
biliousness N: ~biliousnesses
-bilk N: bilks
bilk V: bilked  bilking  bilks
bilker N: bilkers
bill N: bills
bill V: billed  billing  bills
billable A:
billboard N: billboards
-billboard V: billboarded  billboarding  billboards
billet N: billets
billet V: billeted  billeting  billets
billfold N: billfolds
billiard A:
billiards N:
billing N: billings
billingsgate N: ~billingsgates
billion A:
billion N: billions | billion {counting}
billionaire N: billionaires
billionth A:
billionth N: billionths
billow N: billows
billow V: billowed  billowing  billows
billowy A: !billowier  !billowiest
billy N: billies
bimbo N: bimbos (bimboes)
bimetallic A:
bimetallic N: bimetallics
bimetallism N: ~bimetallisms
bimonthly A:
bimonthly N: bimonthlies
bin N: bins
bin V: binned  binning  bins
binary A:
binary N: binaries
bind N: binds
bind V: bound  binding  binds
binder N: binders
bindery N: binderies
binding N: bindings
bindweed N: ~bindweeds
binge N: binges
binge V: binged  binging / bingeing  binges
bingo I:
bingo N: ~bingos
binnacle N: binnacles
binocular A:
binocular N: binoculars
binomial A:
binomial N: binomials
bio N: bios
biochemical A:
biochemical N: biochemicals
biochemically A:
biochemist N: biochemists
biochemistry N: ~biochemistries
biodegradability N: ~biodegradabilities
biodegradable A:
biodegrade V: biodegraded  biodegrading  biodegrades
biodiversity N: ~biodiversities
bioethics N:
biofeedback N: ~biofeedbacks
biographer N: biographers
biographic A:
biographical A:
biographically A:
biography N: biographies
biologic A:
-biologic N: biologics
biological A:
-biological N: biologicals
biologically A:
biologist N: biologists
biology N: ~biologies
biomass N: ~biomasses
bionic A:
bionically A:
bionics N:
biophysical A:
biophysicist N: biophysicists
biophysics N:
biopic N: biopics
biopsy N: biopsies
biopsy V: biopsied  biopsying  biopsies
biorhythm N: biorhythms
biosphere N: biospheres
biotechnological A:
biotechnology N: ~biotechnologies
biotin N: ~biotins
bipartisan A:
bipartisanship N: ~bipartisanships
bipartite A:
biped A:
biped N: bipeds
bipedal A:
biplane N: biplanes
bipolar A:
bipolarity N: ~bipolarities
biracial A:
birch A:
birch N: birches
birch V: birched  birching  birches
bird N: birds
bird V: birded  birding  birds
birdbath N: birdbaths
birdbrain N: birdbrains
birdbrained A:
birder N: birders
birdhouse N: birdhouses
birdie N: birdies
birdie V: birdied  birdieing  birdies
birdlime N: ~birdlimes
-birdlime V: birdlimed  birdliming  birdlimes
birdseed N: ~birdseeds
birdwatcher N: birdwatchers
biretta N: birettas
birth N: births
birth V: birthed  birthing  births
birthday N: birthdays
birthmark N: birthmarks
birthplace N: birthplaces
birthrate N: birthrates
birthright N: birthrights
birthstone N: birthstones
biscuit N: biscuits (biscuit)
bisect V: bisected  bisecting  bisects
bisection N: bisections
bisector N: bisectors
bisexual A:
bisexual N: bisexuals
bisexuality N: ~bisexualities
bisexually A:
bishop N: bishops
-bishop V: bishoped  bishoping  bishops
bishopric N: bishoprics
bismuth N: ~bismuths
bison N: bison (bisons)
bisque N: ~bisques
bistro N: bistros
bit A:
bit N: bits
-bit V: bitted  bitting  bits
bitch N: bitches
bitch V: bitched  bitching  bitches
bitchily A:
bitchiness N: ~bitchinesses
bitchy A: bitchier  bitchiest
bite N: bites
bite V: bit  bitten  biting  bites
biter N: biters
bitingly A:
bitter A: bitterer  bitterest
bitter N: ~bitters
-bitter V: bittered  bittering  bitters
bitterly A:
bittern N: bitterns
bitterness N: ~bitternesses
bitters N:
bittersweet A:
bittersweet N: bittersweets
bitty A: bittier  bittiest
bitumen N: ~bitumens
bituminous A:
bivalent A:
-bivalent N: bivalents
bivalve A:
bivalve N: bivalves
bivouac N: bivouacs
bivouac V: bivouacked  bivouacking  bivouacs
biweekly A:
biweekly N: biweeklies
biyearly A:
biz N: ~bizzes
bizarre A:
bizarrely A:
blab N: ~blabs
blab V: blabbed  blabbing  blabs
-blabber N: blabbers
blabber V: blabbered  blabbering  blabbers
blabbermouth N: blabbermouths
black A: blacker  blackest
black N: blacks
black V: blacked  blacking  blacks
blackamoor N: blackamoors
blackball N: blackballs
blackball V: blackballed  blackballing  blackballs
blackberry N: blackberries
blackbird N: blackbirds
-blackbird V: blackbirded  blackbirding  blackbirds
blackboard N: blackboards
blacken V: blackened  blackening  blackens
blackguard N: blackguards
-blackguard V: blackguarded  blackguarding  blackguards
blackhead N: blackheads
blacking N: ~blackings
blackish A:
blackjack N: blackjacks
blackjack V: blackjacked  blackjacking  blackjacks
blacklist N: blacklists
blacklist V: blacklisted  blacklisting  blacklists
blackly A:
blackmail N: ~blackmails
blackmail V: blackmailed  blackmailing  blackmails
blackmailer N: blackmailers
blackness N: ~blacknesses
blackout N: blackouts
blacksmith N: blacksmiths
blacksnake N: blacksnakes
blackthorn N: blackthorns
blacktop N: blacktops
blacktop V: blacktopped  blacktopping  blacktops
bladder N: bladders
blade N: blades
bladed A:
blah A:
blah N: ~blahs
blahs N:
blamable A:
blame N: ~blames
blame V: blamed  blaming  blames
blameable A:
blameless A:
blamelessly A:
blamelessness N: ~blamelessnesses
blameworthiness N: ~blameworthinesses
blameworthy A: blameworthier  blameworthiest
blanch V: blanched  blanching  blanches
blancmange N: blancmanges
bland A: blander  blandest
blandish V: blandished  blandishing  blandishes
blandishment N: blandishments
blandly A:
blandness N: ~blandnesses
blank A: blanker  blankest
blank N: blanks
blank V: blanked  blanking  blanks
blanket A:
blanket N: blankets
blanket V: blanketed  blanketing  blankets
blankly A:
blankness N: ~blanknesses
blare N: blares
blare V: blared  blaring  blares
blarney N: ~blarneys
blarney V: blarneyed  blarneying  blarneys
blase A:
blaspheme V: blasphemed  blaspheming  blasphemes
blasphemer N: blasphemers
blasphemous A:
blasphemously A:
blasphemy N: blasphemies
blast I:
blast N: blasts
blast V: blasted  blasting  blasts
blaster N: blasters
blastoff N: blastoffs
blatancy N: blatancies
blatant A:
blatantly A:
blather N: ~blathers
blather V: blathered  blathering  blathers
blaze N: blazes
blaze V: blazed  blazing  blazes
blazer N: blazers
blazon N: blazons
blazon V: blazoned  blazoning  blazons
bleach N: bleaches
bleach V: bleached  bleaching  bleaches
bleacher A:
bleacher N: bleachers
bleak A: bleaker  bleakest
-bleak N: bleaks
bleakly A:
bleakness N: ~bleaknesses
blear A: -blearer  -blearest
-blear V: bleared  blearing  blears
blearily A:
bleariness N: ~blearinesses
bleary A: blearier  bleariest
bleat N: bleats
bleat V: bleated  bleating  bleats
-bleed N: bleeds
bleed V: bled  bleeding  bleeds
bleeder N: bleeders
bleeding N: ~bleedings
bleep N: bleeps
bleep V: bleeped  bleeping  bleeps
bleeper N: bleepers
blemish N: blemishes
blemish V: blemished  blemishing  blemishes
blench V: blenched  blenching  blenches
blend N: blends
blend V: blended (blent)  blending  blends
blender N: blenders
bless V: blessed (blest)  blessing  blesses
blessed A: -blesseder  -blessedest
blessedly A:
blessedness N: ~blessednesses
blessing N: blessings
blight N: blights
blight V: blighted  blighting  blights
blimey I:
blimp N: blimps
blind A: blinder  blindest
blind N: blinds
blind V: blinded  blinding  blinds
blinder N: blinders
blindfold A:
blindfold N: blindfolds
blindfold V: blindfolded  blindfolding  blindfolds
-blinding N: blindings
blindingly A:
blindly A:
blindness N: ~blindnesses
blindside V: blindsided  blindsiding  blindsides
blini N: blini (blinis)
blink N: blinks
blink V: blinked  blinking  blinks
blinker N: blinkers
blinker V: blinkered  blinkering  blinkers
blinkered A:
blintz N: blintzes
blintze N: blintzes
blip N: blips
-blip V: blipped  blipping  blips
bliss N: ~blisses
blissful A:
blissfully A:
blissfulness N: ~blissfulnesses
blister N: blisters
blister V: blistered  blistering  blisters
blisteringly A:
blistery A:
blithe A: blither  blithest
blithely A:
blitheness N: ~blithenesses
blithering A:
blithesome A:
blitz N: blitzes
blitz V: blitzed  blitzing  blitzes
blitzkrieg N: blitzkriegs
-blitzkrieg V: blitzkrieged  blitzkrieging  blitzkriegs
blizzard N: blizzards
-bloat N: bloats
bloat V: bloated  bloating  bloats
blob N: blobs
blob V: blobbed  blobbing  blobs
bloc N: blocs
block N: blocks
block V: blocked  blocking  blocks
blockade N: blockades
blockade V: blockaded  blockading  blockades
blockader N: blockaders
blockage N: blockages
blockbuster N: blockbusters
blockbusting N: ~blockbustings
blocker N: blockers
blockhead N: blockheads
blockhouse N: blockhouses
bloke N: blokes
blond A: blonder  blondest
blond N: blonds
blonde A: blonder  blondest
blonde N: blondes
blondish A:
blondness N: ~blondnesses
blood N: ~bloods
blood V: blooded  blooding  bloods
bloodbath N: bloodbaths
bloodcurdling A:
blooded A:
bloodhound N: bloodhounds
bloodiness N: ~bloodinesses
bloodless A:
bloodlessly A:
bloodlessness N: ~bloodlessnesses
bloodletting N: ~bloodlettings
bloodline N: bloodlines
bloodmobile N: bloodmobiles
bloodshed N: ~bloodsheds
bloodshot A:
bloodstain N: bloodstains
bloodstained A:
bloodstock N: ~bloodstocks
bloodstream N: bloodstreams
bloodsucker N: bloodsuckers
bloodsucking A:
bloodthirstily A:
bloodthirstiness N: ~bloodthirstinesses
bloodthirsty A: bloodthirstier  bloodthirstiest
bloody A: bloodier  bloodiest
bloody V: bloodied  bloodying  bloodies
bloom N: blooms
bloom V: bloomed  blooming  blooms
bloomer N: bloomers
bloop N: bloops
bloop V: blooped  blooping  bloops
blooper N: bloopers
blossom N: blossoms
blossom V: blossomed  blossoming  blossoms
blossomy A:
blot N: blots
blot V: blotted  blotting  blots
blotch N: blotches
blotch V: blotched  blotching  blotches
blotchy A: blotchier  blotchiest
blotter N: blotters
blotto A:
blouse N: blouses
blouse V: bloused  blousing  blouses
blow N: blows
blow V: blew (-blowed)  blown (-blowed)  blowing  blows
blower N: blowers
blowfly N: blowflies
blowgun N: blowguns
blowhard N: blowhards
blowout N: blowouts
blowpipe N: blowpipes
blowsy A: blowsier  blowsiest
blowtorch N: blowtorches
blowtorch V: blowtorched  blowtorching  blowtorches
blowup N: blowups
blowy A: blowier  blowiest
blowzy A: blowzier  blowziest
-blubber A:
blubber N: ~blubbers
blubber V: blubbered  blubbering  blubbers
blubbery A:
bludgeon N: bludgeons
bludgeon V: bludgeoned  bludgeoning  bludgeons
blue A: bluer  bluest
blue N: blues
blue V: blued  bluing (blueing)  blues
bluebell N: bluebells
blueberry N: blueberries
bluebird N: bluebirds
bluebonnet N: bluebonnets
bluebottle N: bluebottles
bluefish N: bluefishes | bluefish
bluegill N: bluegills
bluegrass N: ~bluegrasses
blueing N: ~blueings
blueish A:
bluejacket N: bluejackets
bluejay N: bluejays
bluejeans N:
blueness N: ~bluenesses
bluenose N: bluenoses
bluepoint N: bluepoints
blueprint N: blueprints
blueprint V: blueprinted  blueprinting  blueprints
bluestocking N: bluestockings
bluesy A: bluesier  bluesiest
bluet N: bluets
bluff A: bluffer  bluffest
bluff N: bluffs
bluff V: bluffed  bluffing  bluffs
bluffer N: bluffers
bluffly A:
bluffness N: ~bluffnesses
bluing N: ~bluings
bluish A:
blunder N: blunders
blunder V: blundered  blundering  blunders
blunderbuss N: blunderbusses
blunderer N: blunderers
blunt A: blunter  bluntest
blunt V: blunted  blunting  blunts
bluntly A:
bluntness N: ~bluntnesses
blur N: blurs
blur V: blurred  blurring  blurs
blurb N: blurbs
-blurb V: blurbed  blurbing  blurbs
blurriness N: ~blurrinesses
blurry A: blurrier  blurriest
blurt V: blurted  blurting  blurts
blush A:
blush N: blushes
blush V: blushed  blushing  blushes
blusher N: blushers
bluster N: ~blusters
bluster V: blustered  blustering  blusters
blusterer N: blusterers
blusterous A:
blustery A: blusterier  blusteriest
boa N: boas
boar N: boars
board N: boards
board V: boarded  boarding  boards
boarder N: boarders
boarding N: ~boardings
boardinghouse N: boardinghouses
boardroom N: boardrooms
boardwalk N: boardwalks
boast N: boasts
boast V: boasted  boasting  boasts
boaster N: boasters
boastful A:
boastfully A:
boastfulness N: ~boastfulnesses
boat N: boats
boat V: boated  boating  boats
boater N: boaters
boathouse N: boathouses
boating N: ~boatings
boatman N: boatmen
boatswain N: boatswains
bob N: bobs | bob {money}
bob V: bobbed  bobbing  bobs
bobbin N: bobbins
bobble N: bobbles
bobble V: bobbled  bobbling  bobbles
bobby N: bobbies
bobbysoxer N: bobbysoxers
bobcat N: bobcats | bobcat
bobolink N: bobolinks
bobsled N: bobsleds
bobsled V: bobsledded  bobsledding  bobsleds
bobsledder N: bobsledders
bobsleigh N: bobsleighs
bobsleigh V: bobsleighed  bobsleighing  bobsleighs
-bobtail A:
bobtail N: bobtails
-bobtail V: bobtailed  bobtailing  bobtails
bobwhite N: bobwhites
bocce N: ~bocces
bocci N: ~boccis
boccie N: ~boccies
bock N: ~bocks
bod N: bods
bodacious A:
bode V: boded  boding  bodes
bodega N: bodegas
bodice N: bodices
bodied A:
bodily A:
bodkin N: bodkins
body A:
body N: bodies
-body V: bodied  bodying  bodies
bodybuilder N: bodybuilders
bodybuilding N: ~bodybuildings
bodyguard N: bodyguards
bodysuit N: bodysuits
bodywork N: ~bodyworks
boffo A:
bog N: bogs
bog V: bogged  bogging  bogs
bogey N: bogeys
bogey V: bogeyed (bogied)  bogeying  bogeys
bogeyman N: bogeymen
boggle V: boggled  boggling  boggles
boggy A: boggier  boggiest
bogie N: bogies
bogie V: bogied  bogieing  bogies
bogus A:
bogy N: bogies
bogyman N: bogymen
bohemian A:
bohemian N: bohemians
bohemianism N: ~bohemianisms
boil N: boils
boil V: boiled  boiling  boils
boiler N: boilers
boilermaker N: boilermakers
boilerplate N: ~boilerplates
boisterous A:
boisterously A:
boisterousness N: ~boisterousnesses
bola N: bolas
bold A: bolder  boldest
boldface A:
boldface N: ~boldfaces
-boldface V: boldfaced  boldfacing  boldfaces
boldfaced A:
boldly A:
boldness N: ~boldnesses
bole N: boles
bolero N: boleros
bolivar N: bolivars / bolivares
boll N: bolls
bollix N: bollixes
bollix V: bollixed  bollixing  bollixes
bologna N: ~bolognas
boloney N: ~boloneys
bolshevik A:
bolshevik N: bolsheviks (bolsheviki)
bolster N: bolsters
bolster V: bolstered  bolstering  bolsters
-bolt A:
bolt N: bolts
bolt V: bolted  bolting  bolts
bolus N: boluses
bomb N: bombs
bomb V: bombed  bombing  bombs
-bombard N: bombards
bombard V: bombarded  bombarding  bombards
bombardier N: bombardiers
bombardment N: bombardments
bombast N: ~bombasts
bombastic A:
bombastically A:
bomber N: bombers
bombproof A:
bombproof V: bombproofed  bombproofing  bombproofs
bombshell N: bombshells
bonanza N: bonanzas
bonbon N: bonbons
-bond A:
bond N: bonds
bond V: bonded  bonding  bonds
bondage N: ~bondages
bondholder N: bondholders
bonding N: ~bondings
bondman N: bondmen
bondsman N: bondsmen
bondwoman N: bondwomen
-bone A:
bone N: bones
bone V: boned  boning  bones
bonehead A:
bonehead N: boneheads
boneheaded A:
boneless A:
boner N: boners
boney A: bonier (boneyer)  boniest (boneyest)
bonfire N: bonfires
bong N: bongs
bong V: bonged  bonging  bongs
bongo N: bongos (bongoes)
bonhomie N: ~bonhomies
boniness N: ~boninesses
bonito N: bonitos (bonitoes) | bonito
bonkers A:
bonnet N: bonnets
-bonnet V: bonneted  bonneting  bonnets
bonnie A: bonnier  bonniest
-bonnie N: bonnies
bonny A: bonnier  bonniest
-bonny N: bonnies
bonsai A:
bonsai N: bonsai (-bonsais)
bonus N: bonuses
bony A: bonier  boniest
boo I:
boo N: boos
boo V: booed  booing  boos
boob N: boobs
boob V: boobed  boobing  boobs
booboo N: booboos
booby N: boobies
boodle N: boodles
-boodle V: boodled  boodling  boodles
boogeyman N: boogeymen
boogie N: ~boogies
boogie V: boogied  boogieing (-boogying)  boogies
boogieman N: boogiemen
boohoo I:
boohoo N: boohoos
boohoo V: boohooed  boohooing  boohoos
book A:
book N: books
book V: booked  booking  books
bookbinder N: bookbinders
bookbindery N: bookbinderies
bookbinding N: ~bookbindings
bookcase N: bookcases
bookend N: bookends
bookend V: bookended  bookending  bookends
bookie N: bookies
booking N: bookings
bookish A:
bookkeeper N: bookkeepers
bookkeeping N: ~bookkeepings
booklet N: booklets
bookmaker N: bookmakers
bookmaking A:
bookmaking N: ~bookmakings
bookmark N: bookmarks
bookmark V: bookmarked  bookmarking  bookmarks
bookmobile N: bookmobiles
bookplate N: bookplates
bookseller N: booksellers
bookshelf N: bookshelves
bookshop N: bookshops
bookstore N: bookstores
bookworm N: bookworms
boom N: booms
boom V: boomed  booming  booms
boombox N: boomboxes
boomerang N: boomerangs
boomerang V: boomeranged  boomeranging  boomerangs
boon A:
boon N: boons
boondocks N:
boondoggle N: boondoggles
boondoggle V: boondoggled  boondoggling  boondoggles
boondoggler N: boondogglers
boonies N:
boor N: boors
boorish A:
boorishly A:
boorishness N: boorishnesses
boost N: boosts
boost V: boosted  boosting  boosts
booster N: boosters
boot N: boots
boot V: booted  booting  boots
bootblack N: bootblacks
bootee N: bootees
booth N: booths
bootie N: booties
bootleg A:
bootleg N: bootlegs
bootleg V: bootlegged  bootlegging  bootlegs
bootlegger N: bootleggers
bootlegging N: ~bootleggings
bootless A:
bootstrap A:
bootstrap N: bootstraps
bootstrap V: bootstrapped  bootstrapping  bootstraps
booty N: booties
booze N: boozes
booze V: boozed  boozing  boozes
boozer N: boozers
boozy A: boozier  booziest
bop N: ~bops
bop V: bopped  bopping  bops
borax N: ~boraxes (-boraces)
bordello N: bordellos
border A:
border N: borders
border V: bordered  bordering  borders
borderland N: borderlands
borderline A:
borderline N: borderlines
bore N: bores
bore V: bored  boring  bores
boredom N: ~boredoms
borer N: borers
-boring N: borings
boron N: ~borons
borough N: boroughs
borrow V: borrowed  borrowing  borrows
borrower N: borrowers
borrowing N: borrowings
borsch N: ~borsches
borscht N: ~borschts
borzoi N: borzois
bosh I:
bosh N: ~boshes
bosom A:
bosom N: bosoms
-bosom V: bosomed  bosoming  bosoms
bosomy A: -bosomier  -bosomiest
boss A: -bosser  -bossest
boss N: bosses
boss V: bossed  bossing  bosses
bossily A:
bossiness N: ~bossinesses
bossism N: ~bossisms
bossy A: bossier  bossiest
-bossy N: bossies
bosun N: bosuns
botanic A:
botanical A:
-botanical N: botanicals
botanically A:
botanist N: botanists
botany N: ~botanies
botch N: botches
botch V: botched  botching  botches
botcher N: botchers
both P:
bother I:
bother N: bothers
bother V: bothered  bothering  bothers
bothersome A:
bottle N: bottles
bottle V: bottled  bottling  bottles
bottleneck N: bottlenecks
-bottleneck V: bottlenecked  bottlenecking  bottlenecks
bottler N: bottlers
bottom A:
bottom N: bottoms
bottom V: bottomed  bottoming  bottoms
bottomless A:
botulism N: ~botulisms
boudoir N: boudoirs
bouffant A:
bouffant N: bouffants
bougainvillea N: bougainvilleas
bough N: boughs
bouillabaisse N: bouillabaisses
bouillon N: bouillons
boulder N: boulders
boulevard N: boulevards
bounce N: bounces
bounce V: bounced  bouncing  bounces
bouncer N: bouncers
bouncily A:
bounciness N: ~bouncinesses
bouncy A: bouncier  bounciest
bound A:
bound N: bounds
bound V: bounded  bounding  bounds
boundary N: boundaries
bounden A:
bounder N: bounders
boundless A:
boundlessly A:
boundlessness N: ~boundlessnesses
bounteous A:
bounteously A:
bounteousness N: ~bounteousnesses
bountiful A:
bountifully A:
bountifulness N: ~bountifulnesses
bounty N: bounties
bouquet N: bouquets
bourbon N: ~bourbons
bourgeois A:
bourgeois N: bourgeois
bourgeoisie N: ~bourgeoisies
bout N: bouts
boutique N: boutiques
boutonniere N: boutonnieres
bouzouki N: bouzoukis (-bouzoukia)
bovine A:
bovine N: bovines
bow A:
bow N: bows
bow V: bowed  bowing  bows
bowdlerization N: bowdlerizations
bowdlerize V: bowdlerized  bowdlerizing  bowdlerizes
bowel N: bowels
-bowel V: boweled (bowelled)  boweling (bowelling)  bowels
bower N: bowers
-bower V: bowered  bowering  bowers
bowl N: bowls
bowl V: bowled  bowling  bowls
bowlder N: bowlders
bowleg N: bowlegs
bowlegged A:
bowler N: bowlers
bowlful N: bowlfuls
bowline N: bowlines
bowling N: ~bowlings
bowman N: bowmen
bowsprit N: bowsprits
bowstring N: bowstrings
-bowstring V: bowstringed (bowstrung)  bowstringing  bowstrings
bowwow I:
bowwow N: bowwows
box N {container}: boxes
box N {shrub}: box / boxes
box V: boxed  boxing  boxes
boxcar N: boxcars
boxer N: boxers
boxing N: ~boxings
boxlike A:
boxwood N: ~boxwoods
boxy A: boxier  boxiest
boy I:
boy N: boys
boycott N: boycotts
boycott V: boycotted  boycotting  boycotts
boyfriend N: boyfriends
boyhood N: boyhoods
boyish A:
boyishly A:
boyishness N: ~boyishnesses
boysenberry N: boysenberries
bozo N: bozos
bra N: bras
brace N: braces | brace {pair}
brace V: braced  bracing  braces
bracelet N: bracelets
bracer N: bracers
bracero N: braceros
-bracing N: bracings
bracken N: ~brackens
bracket N: brackets
bracket V: bracketed  bracketing  brackets
brackish A:
brackishness N: ~brackishnesses
bract N: bracts
brad N: brads
-brad V: bradded  bradding  brads
brae N: braes
-brag A: bragger  braggest
brag N: brags
brag V: bragged  bragging  brags
braggadocio N: braggadocios
braggart A:
braggart N: braggarts
bragger N: braggers
braid N: braids
braid V: braided  braiding  braids
braiding N: ~braidings
braille N: ~brailles
-braille V: brailled  brailling  brailles
brain N: brains
brain V: brained  braining  brains
brainchild N: brainchildren
braininess N: ~braininesses
brainless A:
brainlessly A:
brainstorm N: brainstorms
brainstorm V: brainstormed  brainstorming  brainstorms
brainstorming N: ~brainstormings
brainteaser N: brainteasers
brainwash V: brainwashed  brainwashing  brainwashes
brainwashing N: ~brainwashings
brainy A: brainier  brainiest
braise V: braised  braising  braises
brake N: brakes
brake V: braked  braking  brakes
brakeman N: brakemen
bramble N: brambles
-bramble V: brambled  brambling  brambles
brambly A: !bramblier  !brambliest
bran N: ~brans
-bran V: branned  branning  brans
branch N: branches
branch V: branched  branching  branches
branchlike A:
brand N: brands
brand V: branded  branding  brands
brander N: branders
-brander V: brandered  brandering  branders
-brandish N: brandishes
brandish V: brandished  brandishing  brandishes
brandy N: brandies
brandy V: brandied  brandying  brandies
brash A: brasher  brashest
-brash N: brashes
brashly A:
brashness N: ~brashnesses
brass A:
brass N: brasses
brasserie N: brasseries
brassiere N: brassieres
brassily A:
brassiness N: ~brassinesses
brassy A: brassier  brassiest
-brassy N: brassies
brat N: brats
bratty A: brattier  brattiest
bratwurst N: bratwursts
bravado N: ~bravadoes / ~bravados
brave A: braver  bravest
brave N: braves
brave V: braved  braving  braves
bravely A:
braveness N: ~bravenesses
bravery N: ~braveries
bravo N: bravos (-bravoes -bravi)
-bravo V: bravoed  bravoing  bravos (bravoes)
bravura A:
bravura N: bravuras (-bravure)
brawl N: brawls
brawl V: brawled  brawling  brawls
brawler N: brawlers
brawn N: ~brawns
brawniness N: ~brawninesses
brawny A: brawnier  brawniest
bray N: brays
bray V: brayed  braying  brays
braze V: brazed  brazing  brazes
brazen A:
brazen V: brazened  brazening  brazens
brazenly A:
brazenness N: ~brazennesses
brazer N: brazers
brazier N: braziers
breach N: breaches
breach V: breached  breaching  breaches
bread N: ~breads
bread V: breaded  breading  breads
breadbasket N: breadbaskets
breadboard N: breadboards
-breadboard V: breadboarded  breadboarding  breadboards
breadbox N: breadboxes
breadcrumb N: breadcrumbs
breadfruit N: breadfruits
breadline N: breadlines
breadth N: breadths
breadwinner N: breadwinners
break N: breaks
break V: broke  broken  breaking  breaks
breakable A:
breakable N: breakables
breakage N: breakages
breakaway A:
breakaway N: breakaways
breakdown N: breakdowns
breaker N: breakers
breakeven A:
breakeven N: ~breakevens
breakfast N: breakfasts
breakfast V: breakfasted  breakfasting  breakfasts
breakfront A:
breakfront N: breakfronts
breakneck A:
breakout N: breakouts
breakthrough N: breakthroughs
breakup N: breakups
breakwater N: breakwaters
bream N: breams | bream
-bream V: breamed  breaming  breams
breast N: breasts
breast V: breasted  breasting  breasts
breastbone N: breastbones
breastplate N: breastplates
breaststroke N: breaststrokes
breastwork N: breastworks
breath N: breaths
breathable A:
breathalyze V: breathalyzed  breathalyzing  breathalyzes
breathe V: breathed  breathing  breathes
breather N: breathers
breathing N: ~breathings
breathless A:
breathlessly A:
breathlessness N: ~breathlessnesses
breathtaking A:
breathtakingly A:
breathy A: breathier  breathiest
breech A:
breech N: breeches
-breech V: breeched  breeching  breeches
breed N: breeds
breed V: bred  breeding  breeds
breeder N: breeders
breeding N: ~breedings
breeze N: breezes
breeze V: breezed  breezing  breezes
breezeway N: breezeways
breezily A:
breeziness N: ~breezinesses
breezy A: breezier  breeziest
breve N: breves
brevet N: brevets
brevet V: brevetted (breveted)  brevetting (breveting)  brevets
breviary N: breviaries
brevity N: ~brevities
brew N: brews
brew V: brewed  brewing  brews
brewer N: brewers
brewery N: breweries
brewpub N: brewpubs
briar N: briars
bribe N: bribes
bribe V: bribed  bribing  bribes
briber N: bribers
bribery N: ~briberies
brick A:
brick N: bricks
brick V: bricked  bricking  bricks
brickbat N: brickbats
bricklayer N: bricklayers
bricklaying N: ~bricklayings
brickwork N: ~brickworks
bridal A:
bridal N: bridals
bride N: brides
bridegroom N: bridegrooms
bridesmaid N: bridesmaids
bridge N: bridges
bridge V: bridged  bridging  bridges
bridgeable A:
bridgehead N: bridgeheads
bridgework N: ~bridgeworks
bridle N: bridles
bridle V: bridled  bridling  bridles
brie N: ~bries
brief A: briefer  briefest
brief N: briefs
brief V: briefed  briefing  briefs
briefcase N: briefcases
briefing N: briefings
briefly A:
briefness N: ~briefnesses
brier N: briers
brig N: brigs
brigade N: brigades
-brigade V: brigaded  brigading  brigades
brigadier N: brigadiers
brigand N: brigands
brigandage N: ~brigandages
brigantine N: brigantines
bright A: brighter  brightest
brighten V: brightened  brightening  brightens
brightener N: brighteners
brightly A:
brights N:
brightness N: ~brightnesses
brilliance N: ~brilliances
brilliancy N: ~brilliancies
brilliant A:
brilliant N: brilliants
brilliantine N: ~brilliantines
brilliantly A:
brim N: brims
brim V: brimmed  brimming  brims
brimful A:
brimfull A:
brimless A:
brimstone N: ~brimstones
brindle A:
brindle N: ~brindles
brindled A:
brine N: ~brines
-brine V: brined  brining  brines
bring V: brought  bringing  brings
bringer N: bringers
brininess N: ~brininesses
brink N: brinks
brinkmanship N: ~brinkmanships
brinksmanship N: ~brinksmanships
briny A: brinier  briniest
-briny N: brinies
brioche N: brioches
briquet N: briquets
-briquet V: briquetted  briquetting  briquets
briquette N: briquettes
-briquette V: briquetted  briquetting  briquettes
brisk A: brisker  briskest
brisk V: brisked  brisking  brisks
brisket N: briskets
briskly A:
briskness N: ~brisknesses
bristle N: bristles
bristle V: bristled  bristling  bristles
bristly A: bristlier  bristliest
britches N:
brittle A: brittler  brittlest
brittle N: ~brittles
-brittle V: brittled  brittling  brittles
brittleness N: ~brittlenesses
bro N: bros
broach N: broaches
broach V: broached  broaching  broaches
broad A: broader  broadest
broad N: broads
broadband A:
broadband N: ~broadbands
broadcast A:
broadcast N: broadcasts
broadcast V: broadcast (broadcasted)  broadcasting  broadcasts
broadcaster N: broadcasters
broadcasting N: ~broadcastings
broadcloth N: ~broadcloths
broaden V: broadened  broadening  broadens
broadloom A:
broadloom N: ~broadlooms
broadly A:
broadminded A:
broadness N: ~broadnesses
broadsheet N: broadsheets
broadside A:
broadside N: broadsides
broadside V: broadsided  broadsiding  broadsides
broadsword N: broadswords
brocade N: ~brocades
brocade V: brocaded  brocading  brocades
broccoli N: ~broccolis
brochette N: brochettes
brochure N: brochures
brogan N: brogans
brogue N: brogues
broil N: broils
broil V: broiled  broiling  broils
broiler N: broilers
broke A:
brokenhearted A:
brokenheartedly A:
brokenly A:
brokenness N: ~brokennesses
broker N: brokers
broker V: brokered  brokering  brokers
brokerage N: brokerages
bromide N: bromides
bromidic A:
bromine N: ~bromines
bronc N: broncs
bronchial A:
bronchitic A:
bronchitis N: ~bronchitises
broncho N: bronchos
bronchus N: bronchi
bronco N: broncos
broncobuster N: broncobusters
brontosaur N: brontosaurs
brontosaurus N: brontosauruses (brontosauri)
bronze A:
bronze N: bronzes
bronze V: bronzed  bronzing  bronzes
brooch N: brooches
brood A:
brood N: broods
brood V: brooded  brooding  broods
brooder N: brooders
brooding N: ~broodings
broodingly A:
broodmare N: broodmares
broody A: broodier  broodiest
broody N:
brook N: brooks
brook V: brooked  brooking  brooks
brooklet N: brooklets
broom N: brooms
-broom V: broomed  brooming  brooms
broomstick N: broomsticks
broth N: broths
brothel N: brothels
brother A:
brother I:
brother N: brothers | brethren {religious}
brotherhood N: brotherhoods
brotherliness N: ~brotherlinesses
brotherly A:
brougham N: broughams
brouhaha N: brouhahas
brow N: brows
browbeat V: browbeat  browbeaten  browbeating  browbeats
brown A: browner  brownest
brown N: browns
brown V: browned  browning  browns
brownie N: brownies
brownish A:
brownness N: ~brownnesses
brownout N: brownouts
brownstone N: brownstones
browse N: browses
browse V: browsed  browsing  browses
browser N: browsers
brr I:
bruin N: bruins
bruise N: bruises
bruise V: bruised  bruising  bruises
bruiser N: bruisers
bruising N: ~bruisings
-bruit N: bruits
bruit V: bruited  bruiting  bruits
brunch N: brunches
brunch V: brunched  brunching  brunches
brunet A:
brunet N: brunets
brunette A:
brunette N: brunettes
brunt N: ~brunts
brush N: brushes
brush V: brushed  brushing  brushes
brushoff N: brushoffs
brushwood N: ~brushwoods
brushwork N: ~brushworks
brusk A: brusker  bruskest
brusque A: brusquer  brusquest
brusquely A:
brusqueness N: ~brusquenesses
brutal A:
brutality N: brutalities
brutalization N: ~brutalizations
brutalize V: brutalized  brutalizing  brutalizes
brutally A:
brute A:
brute N: brutes
-brute V: bruted  bruting  brutes
brutish A:
brutishly A:
brutishness N: ~brutishnesses
bub N: bubs
bubble N: bubbles
bubble V: bubbled  bubbling  bubbles
bubblegum N: ~bubblegums
bubbly A: bubblier  bubbliest
bubbly N: ~bubblies
bubo N: buboes
buccaneer N: buccaneers
buck A:
buck N: bucks / buck
buck V: bucked  bucking  bucks
buckaroo N: buckaroos
buckboard N: buckboards
bucket N: buckets
bucket V: bucketed  bucketing  buckets
bucketful N: bucketfuls
buckeye N: buckeyes
buckle N: buckles
buckle V: buckled  buckling  buckles
buckler N: bucklers
-buckler V: bucklered  bucklering  bucklers
buckram A:
buckram N: ~buckrams
-buckram V: buckramed  buckraming  buckrams
bucksaw N: bucksaws
buckshot N: ~buckshots
buckskin A:
buckskin N: buckskins
bucktooth N: buckteeth
bucktoothed A:
buckwheat A:
buckwheat N: ~buckwheats
bucolic A:
bucolic N: bucolics
bucolically A:
bud N: buds
bud V: budded  budding  buds
-buddy A: buddier  buddiest
buddy N: buddies
-buddy V: buddied  buddying  buddies
-budge N: budges
budge V: budged  budging  budges
budgerigar N: budgerigars
budget A:
budget N: budgets
budget V: budgeted  budgeting  budgets
budgetary A:
budgie N: budgies
buff A:
buff N: buffs
buff V: buffed  buffing  buffs
buffalo N: buffaloes (buffalos) | buffalo
buffalo V: buffaloed  buffaloing  buffaloes (buffalos)
buffer N: buffers
buffer V: buffered  buffering  buffers
buffet N: buffets
buffet V: buffeted  buffeting  buffets
buffoon N: buffoons
buffoonery N: ~buffooneries
buffoonish A:
bug N: bugs
bug V: bugged  bugging  bugs
bugaboo N: bugaboos
bugbear N: bugbears
bugger N: buggers
bugger V: buggered  buggering  buggers
buggered A:
buggy A: buggier  buggiest
buggy N: buggies
bugle N: bugles
bugle V: bugled  bugling  bugles
bugler N: buglers
build N: builds
build V: built (-@builded)  building  builds
builder N: builders
building N: buildings
buildup N: buildups
bulb N: bulbs
bulbous A:
bulge N: bulges
bulge V: bulged  bulging  bulges
bulgy A: bulgier  bulgiest
bulimarexia N: ~bulimarexias
bulimia N: ~bulimias
bulimic A:
bulimic N: bulimics
bulk A:
bulk N: bulks
bulk V: bulked  bulking  bulks
bulkhead N: bulkheads
bulkiness N: ~bulkinesses
bulky A: bulkier  bulkiest
bull A:
bull I:
bull N: bulls
bull V: bulled  bulling  bulls
bulldog A:
bulldog N: bulldogs
bulldog V: bulldogged  bulldogging  bulldogs
bulldoze V: bulldozed  bulldozing  bulldozes
bulldozer N: bulldozers
bullet N: bullets
-bullet V: bulleted  bulleting  bullets
bulletin N: bulletins
bulletin V: bulletined  bulletining  bulletins
bulletproof A:
bulletproof V: bulletproofed  bulletproofing  bulletproofs
bullfight N: bullfights
bullfighter N: bullfighters
bullfighting N: ~bullfightings
bullfinch N: bullfinches
bullfrog N: bullfrogs
bullhead N: bullheads
bullheaded A:
bullheadedly A:
bullheadedness N: ~bullheadednesses
bullhorn N: bullhorns
bullion N: ~bullions
bullish A:
bullishly A:
bullishness N: ~bullishnesses
bullock N: bullocks
bullpen N: bullpens
bullring N: bullrings
bullshit N: ~bullshits
bullshit V: bullshitted / bullshit (-bullshat)  bullshitting  bullshits
bullshitter N: bullshitters
bully A: -bullier  -bulliest
bully N: bullies
bully V: bullied  bullying  bullies
bulrush N: bulrushes
bulwark N: bulwarks
-bulwark V: bulwarked  bulwarking  bulwarks
bum A: bummer  bummest
bum N: bums
bum V: bummed  bumming  bums
-bumble N: bumbles
bumble V: bumbled  bumbling  bumbles
bumblebee N: bumblebees
bumbler N: bumblers
bummer N: bummers
bump N: bumps
bump V: bumped  bumping  bumps
bumper A:
bumper N: bumpers
-bumper V: bumpered  bumpering  bumpers
bumpiness N: ~bumpinesses
bumpkin N: bumpkins
bumptious A:
bumptiously A:
bumptiousness N: ~bumptiousnesses
bumpy A: bumpier  bumpiest
bun N: buns
bunch N: bunches
bunch V: bunched  bunching  bunches
bunchy A: bunchier  bunchiest
bunco N: buncos
bunco V: buncoed  buncoing  buncos
buncombe N: ~buncombes
bundle N: bundles
bundle V: bundled  bundling  bundles
-bung A:
bung N: bungs
bung V: bunged  bunging  bungs
bungalow N: bungalows
bungee N: bungees
bunghole N: bungholes
bungle N: bungles
bungle V: bungled  bungling  bungles
bungler N: bunglers
bunion N: bunions
bunk N: bunks
bunk V: bunked  bunking  bunks
bunker A:
bunker N: bunkers
-bunker V: bunkered  bunkering  bunkers
bunkhouse N: bunkhouses
bunko N: bunkos
-bunko V: bunkoed  bunkoing  bunkos
bunkum N: ~bunkums
bunny A:
bunny N: bunnies
bunt N: bunts
bunt V: bunted  bunting  bunts
bunting N: buntings
buoy N: buoys
buoy V: buoyed  buoying  buoys
buoyancy N: ~buoyancies
buoyant A:
buoyantly A:
bur N: burs
-bur V: burred  burring  burs
burble N: burbles
burble V: burbled  burbling  burbles
burbs N:
burden N: burdens
burden V: burdened  burdening  burdens
burdensome A:
burdock N: ~burdocks
bureau N: bureaus (bureaux)
bureaucracy N: bureaucracies
bureaucrat N: bureaucrats
bureaucratic A:
bureaucratically A:
bureaucratization N: ~bureaucratizations
bureaucratize V: bureaucratized  bureaucratizing  bureaucratizes
burg N: burgs
-burgeon N: burgeons
burgeon V: burgeoned  burgeoning  burgeons
burger N: burgers
burgh N: burghs
burgher N: burghers
burglar N: burglars
burglarize V: burglarized  burglarizing  burglarizes
burglarproof A:
burglarproof V: burglarproofed  burglarproofing  burglarproofs
burglary N: burglaries
burgle V: burgled  burgling  burgles
burgomaster N: burgomasters
burgundy N: burgundies
burial N: burials
burl N: burls
-burl V: burled  burling  burls
burlap N: ~burlaps
burled A:
burlesque A:
burlesque N: burlesques
burlesque V: burlesqued  burlesquing  burlesques
burliness N: ~burlinesses
burly A: burlier  burliest
burn N: burns
burn V: burned (burnt)  burning  burns
burnable A:
burnable N: burnables
burner N: burners
-burning N: burnings
burnish N: ~burnishes
burnish V: burnished  burnishing  burnishes
burnisher N: burnishers
burnoose N: burnooses
burnous N: burnouses
burnout N: burnouts
burp N: burps
burp V: burped  burping  burps
burr N: burrs
burr V: burred  burring  burrs
burrito N: burritos
burro N: burros
burrow N: burrows
burrow V: burrowed  burrowing  burrows
burrower N: burrowers
bursa N: bursae (bursas)
bursar N: bursars
bursary N: bursaries
bursitis N: ~bursitises
burst N: bursts
burst V: burst (bursted)  bursting  bursts
bury V: buried  burying  buries
bus N: buses (busses)
bus V: bused (bussed)  busing (bussing)  buses (busses)
busboy N: busboys
busby N: busbies
busgirl N: busgirls
-bush A:
bush N: bushes
bush V: bushed  bushing  bushes
bushel N: bushels
bushel V: busheled (bushelled)  busheling (bushelling)  bushels
bushiness N: ~bushinesses
bushing N: bushings
bushman N: bushmen
bushmaster N: bushmasters
bushwhack V: bushwhacked  bushwhacking  bushwhacks
bushwhacker N: bushwhackers
bushy A: bushier  bushiest
busily A:
business A:
business N: businesses
businesslike A:
businessman N: businessmen
businessperson N: businesspersons (-businesspeople)
businesswoman N: businesswomen
busing N: ~busings
buskin N: buskins
buss N: busses
buss V: bussed  bussing  busses
bussing N: ~bussings
bust A:
bust N: busts
bust V: busted (bust)  busting  busts
buster N: busters
bustle N: bustles
bustle V: bustled  bustling  bustles
busty A: bustier  bustiest
busy A: busier  busiest
busy V: busied  busying  busies
busybody N: busybodies
busyness N: ~busynesses
busywork N: ~busyworks
but A:
but C:
but P:
butane N: ~butanes
butch A: -butcher  -butchest
butch N: butches
butcher N: butchers
butcher V: butchered  butchering  butchers
butchery N: butcheries
butler N: butlers
buts N:
butt N: butts
butt V: butted  butting  butts
butte N: buttes
butter N: ~butters
butter V: buttered  buttering  butters
butterball N: butterballs
buttercup N: buttercups
butterfat N: ~butterfats
butterfingered A:
butterfingers N:
butterfly N: butterflies
butterfly V: butterflied  butterflying  butterflies
buttermilk N: ~buttermilks
butternut N: butternuts
butterscotch N: ~butterscotches
buttery A: butterier  butteriest
buttery N: butteries
buttock N: buttocks
button N: buttons
button V: buttoned  buttoning  buttons
buttonhole N: buttonholes
buttonhole V: buttonholed  buttonholing  buttonholes
buttonwood N: buttonwoods
buttress N: buttresses
buttress V: buttressed  buttressing  buttresses
buxom A: -buxomer  -buxomest
buy N: buys
buy V: bought  bought (-boughten)  buying  buys
buyback N: buybacks
buyer N: buyers
buyout N: buyouts
buzz N: buzzes
buzz V: buzzed  buzzing  buzzes
buzzard N: buzzards
buzzer N: buzzers
buzzword N: buzzwords
by P:
bye I:5:32 PM 9/21/2015
bye N: byes
byelaw N: byelaws
bygone A:
bygone N: bygones
bylaw N: bylaws
byline N: bylines
-byline V: bylined  bylining  bylines
bypass N: bypasses
bypass V: bypassed (bypast)  bypassing  bypasses
bypath N: bypaths
byplay N: ~byplays
byproduct N: byproducts
byroad N: byroads
bystander N: bystanders
byte N: bytes
byway N: byways
byword N: bywords
byzantine A:
