dab N: dabs
dab V: dabbed  dabbing  dabs
dabber N: dabbers
dabble V: dabbled  dabbling  dabbles
dabbler N: dabblers
dace N: dace | daces
dacha N: dachas
dachshund N: dachshunds
dactyl N: dactyls
dactylic A:
dactylic N: dactylics
dad N: dads
dadaism N: ~dadaisms
dadaist A:
dadaist N: dadaists
daddy N: daddies
dado N: dadoes / dados
-dado V: dadoed  dadoing  dadoes (dados)
daemon N: daemons
daemonic A:
daffiness N: ~daffinesses
daffodil N: daffodils
daffy A: daffier  daffiest
daft A: dafter  daftest
daftly A:
daftness N: ~daftnesses
dagger N: daggers
-dagger V: daggered  daggering  daggers
daguerreotype N: daguerreotypes
daguerreotype V: daguerreotyped  daguerreotyping  daguerreotypes
dahlia N: dahlias
dailiness N: ~dailinesses
daily A:
daily N: dailies
daintily A:
daintiness N: ~daintinesses
dainty A: daintier  daintiest
dainty N: dainties
daiquiri N: daiquiris
dairy A:
dairy N: dairies
dairying N: ~dairyings
dairymaid N: dairymaids
dairyman N: dairymen
dairywoman N: dairywomen
dais N: daises
daisy N: daisies
dale N: dales
dalliance N: dalliances
dallier N: dalliers
dally V: dallied  dallying  dallies
dalmatian N: dalmatians
dam N: dams
dam V: dammed  damming  dams
damage N: ~damages
damage V: damaged  damaging  damages
damageable A:
damages N:
damask A:
damask N: ~damasks
damask V: damasked  damasking  damasks
dame N: dames
dammit I:
damn A:
damn I:
damn N: damns
damn V: damned  damning  damns
damnable A:
damnably A:
damnation I:
damnation N: ~damnations
damndest A:
-damndest N: damndests
damned A: -damneder  damnedest / damndest
-damnedest N: damnedests
damp A: damper  dampest
damp N: ~damps
damp V: damped  damping  damps
dampen V: dampened  dampening  dampens
dampener N: dampeners
damper N: dampers
damply A:
dampness N: ~dampnesses
damsel N: damsels
damselfly N: damselflies
damson N: damsons
dance N: dances
dance V: danced  dancing  dances
dancer N: dancers
dancing N: ~dancings
dandelion N: dandelions
dander N: ~danders
dandify V: dandified  dandifying  dandifies
dandle V: dandled  dandling  dandles
dandruff N: ~dandruffs
dandy A: dandier  dandiest
dandy N: dandies
dang A:
dang I:
dang V: danged  danging  dangs
danger N: dangers
dangerous A:
dangerously A:
-dangle N: dangles
dangle V: dangled  dangling  dangles
dangler N: danglers
danish N: danishes (danish)
dank A: danker  dankest
dankly A:
dankness N: ~danknesses
danseuse N: danseuses
dapper A: dapperer  dapperest
dapple A:
dapple N: dapples
dapple V: dappled  dappling  dapples
dare N: dares
dare V: dared (@durst)  daring  dares (dare)
daredevil A:
daredevil N: daredevils
daredevilry N: ~daredevilries
darer N: darers
daresay V:
daring N: ~darings
daringly A:
dark A: darker  darkest
dark N: ~darks
-dark V: darked  darking  darks
darken V: darkened  darkening  darkens
darkener N: darkeners
darkly A: ~darklier  ~darkliest
darkness N: ~darknesses
darkroom N: darkrooms
darling A: -  darlingest
darling N: darlings
darn A:
darn I:
darn N: darns
darn V: darned  darning  darns
darned A: darneder  darnedest
darner N: darners
dart N: darts
dart V: darted  darting  darts
dartboard N: dartboards
darter N: darters
dash N: dashes
dash V: dashed  dashing  dashes
dashboard N: dashboards
dasher N: dashers
dashiki N: dashikis
dashingly A:
-dastard A:
dastard N: dastards
dastardliness N: ~dastardlinesses
dastardly A:
databank N: databanks
database N: databases
date N: dates
date V: dated  dating  dates
dateless A:
dateline N: datelines
dateline V: datelined  datelining  datelines
dater N: daters
dative A:
dative N: datives
datum N: data | -datums {reference point}
daub N: daubs
daub V: daubed  daubing  daubs
dauber N: daubers
daughter A:
daughter N: daughters
daughterly A:
daunt V: daunted  daunting  daunts
dauntingly A:
dauntless A:
dauntlessly A:
dauntlessness N: ~dauntlessnesses
dauphin N: dauphins
davenport N: davenports
davit N: davits
dawdle V: dawdled  dawdling  dawdles
dawdler N: dawdlers
dawn N: dawns
dawn V: dawned  dawning  dawns
day N: days
daybed N: daybeds
daybreak N: ~daybreaks
daycare N: ~daycares
daydream N: daydreams
daydream V: daydreamed (daydreamt)  daydreaming  daydreams
daydreamer N: daydreamers
daylight A:
daylight N: ~daylights
-daylight V: daylighted (daylit)  daylighting  daylights
daylights N:
daytime A:
daytime N: ~daytimes
daze N: dazes
daze V: dazed  dazing  dazes
dazedly A:
dazzle N: ~dazzles
dazzle V: dazzled  dazzling  dazzles
dazzler N: dazzlers
dazzlingly A:
deacon N: deacons
-deacon V: deaconed  deaconing  deacons
deaconess N: deaconesses
deactivate V: deactivated  deactivating  deactivates
deactivation N: ~deactivations
dead A: deader  deadest
dead N: dead
deadbeat A:
deadbeat N: deadbeats
deadbolt N: deadbolts
deaden V: deadened  deadening  deadens
deadline N: deadlines
deadliness N: ~deadlinesses
deadlock N: deadlocks
deadlock V: deadlocked  deadlocking  deadlocks
deadly A: deadlier  deadliest
deadpan A:
deadpan N: deadpans
deadpan V: deadpanned  deadpanning  deadpans
deadweight N: deadweights
deadwood N: ~deadwoods
deaf A: deafer  deafest
deafen V: deafened  deafening  deafens
-deafening N: deafenings
deafeningly A:
deafness N: ~deafnesses
-deal A:
deal N: deals
deal V: dealt  dealing  deals
dealer N: dealers
dealership N: dealerships
dealing N: dealings
dean N: deans
deanery N: deaneries
deanship N: ~deanships
dear A: dearer  dearest
dear I:
dear N: dears
dearie N: dearies
dearly A:
dearness N: ~dearnesses
dearth N: dearths
deary N: dearies
death N: deaths
deathbed A:
deathbed N: deathbeds
deathblow N: deathblows
deathless A:
deathlessly A:
deathlike A:
deathly A: -deathlier  -deathliest
deathtrap N: deathtraps
deathwatch N: deathwatches
deb N: debs
debacle N: debacles
debar V: debarred  debarring  debars
debark V: debarked  debarking  debarks
debarkation N: ~debarkations
debarment N: ~debarments
debase V: debased  debasing  debases
debasement N: debasements
debatable A:
debate N: debates
debate V: debated  debating  debates
debater N: debaters
debating N: ~debatings
debauch N: debauches
debauch V: debauched  debauching  debauches
debauchee N: debauchees
debauchery N: debaucheries
debenture N: debentures
debilitate V: debilitated  debilitating  debilitates
debilitation N: ~debilitations
debility N: debilities
debit N: debits
debit V: debited  debiting  debits
debonair A:
debonaire A:
debonairly A:
debonairness N: ~debonairnesses
-debouch N: debouches
debouch V: debouched  debouching  debouches
debrief V: debriefed  debriefing  debriefs
debriefing N: debriefings
debris N: ~debris
debt N: debts
debtor N: debtors
debug V: debugged  debugging  debugs
debunk V: debunked  debunking  debunks
debut N: debuts
debut V: debuted  debuting  debuts
debutante N: debutantes
decade N: decades
decadence N: ~decadences
decadency N: ~decadencies
decadent A:
decadent N: decadents
decadently A:
decaf N: ~decafs
decaffeinate V: decaffeinated  decaffeinating  decaffeinates
decagon N: decagons
decal N: decals
-decal V: decaled (decalled)  decaling (decalling)  decals
decamp V: decamped  decamping  decamps
decampment N: ~decampments
decant V: decanted  decanting  decants
decanter N: decanters
decapitate V: decapitated  decapitating  decapitates
decapitation N: decapitations
decapitator N: decapitators
decathlon N: decathlons
decay N: ~decays
decay V: decayed  decaying  decays
decease N: deceases
decease V: deceased  deceasing  deceases
deceased N: ~deceased
decedent N: decedents
deceit N: deceits
deceitful A:
deceitfully A:
deceitfulness N: ~deceitfulnesses
deceive V: deceived  deceiving  deceives
deceiver N: deceivers
deceivingly A:
decelerate V: decelerated  decelerating  decelerates
deceleration N: ~decelerations
decelerator N: decelerators
decency N: decencies
decennial A:
decennial N: decennials
decent A: -decenter  -decentest
decently A:
decentralization N: ~decentralizations
decentralize V: decentralized  decentralizing  decentralizes
deception N: deceptions
deceptive A:
deceptively A:
deceptiveness N: ~deceptivenesses
decibel N: decibels
decidable A:
decide V: decided  deciding  decides
decidedly A:
deciduous A:
deciliter N: deciliters
decimal A:
decimal N: decimals
decimate V: decimated  decimating  decimates
decimation N: ~decimations
decimeter N: decimeters
decipher V: deciphered  deciphering  deciphers
decipherable A:
decision N: decisions
-decision V: decisioned  decisioning  decisions
decisive A:
decisively A:
decisiveness N: ~decisivenesses
deck N: decks
deck V: decked  decking  decks
deckhand N: deckhands
declaim V: declaimed  declaiming  declaims
declaimer N: declaimers
declamation N: declamations
declamatory A:
declarable A:
declaration N: declarations
declarative A:
declaratory A:
declare V: declared  declaring  declares
declarer N: declarers
declassification N: ~declassifications
declassify V: declassified  declassifying  declassifies
declension N: declensions
declination N: ~declinations
decline N: declines
decline V: declined  declining  declines
decliner N: decliners
declivity N: declivities
decode V: decoded  decoding  decodes
decoder N: decoders
decolletage N: decolletages
decollete A:
decolonization N: ~decolonizations
decolonize V: decolonized  decolonizing  decolonizes
decommission V: decommissioned  decommissioning  decommissions
decompose V: decomposed  decomposing  decomposes
decomposition N: ~decompositions
decompress V: decompressed  decompressing  decompresses
decompression N: ~decompressions
decongestant A:
decongestant N: decongestants
deconstruction N: deconstructions
decontaminate V: decontaminated  decontaminating  decontaminates
decontamination N: ~decontaminations
decontrol V: decontrolled  decontrolling  decontrols
decor N: decors
decorate V: decorated  decorating  decorates
decorating N: ~decoratings
decoration N: decorations
decorative A:
decoratively A:
decorator N: decorators
decorous A:
decorously A:
decorousness N: ~decorousnesses
decorum N: ~decorums
decoupage N: decoupages
decoupage V: decoupaged  decoupaging  decoupages
decoy N: decoys
decoy V: decoyed  decoying  decoys
decrease N: decreases
decrease V: decreased  decreasing  decreases
decreasingly A:
decree N: decrees
decree V: decreed  decreeing  decrees
decrepit A:
decrepitude N: ~decrepitudes
decrescendo A:
decrescendo N: decrescendos (decrescendi)
decriminalization N: ~decriminalizations
decriminalize V: decriminalized  decriminalizing  decriminalizes
decry V: decried  decrying  decries
-dedicate A:
dedicate V: dedicated  dedicating  dedicates
dedication N: dedications
dedicator N: dedicators
dedicatory A:
deduce V: deduced  deducing  deduces
deducible A:
deduct V: deducted  deducting  deducts
deductible A:
deductible N: deductibles
deduction N: deductions
deductive A:
deductively A:
deed N: deeds
deed V: deeded  deeding  deeds
deejay N: deejays
deem V: deemed  deeming  deems
deep A: deeper  deepest
deep N: deeps
deepen V: deepened  deepening  deepens
deeply A:
deepness N: ~deepnesses
deer N: deer (deers)
deerskin N: ~deerskins
deescalate V: deescalated  deescalating  deescalates
deescalation N: ~deescalations
def A: deffer  deffest
deface V: defaced  defacing  defaces
defacement N: ~defacements
defacer N: defacers
defalcate V: defalcated  defalcating  defalcates
defalcation N: defalcations
defamation N: ~defamations
defamatory A:
defame V: defamed  defaming  defames
defamer N: defamers
default N: defaults
default V: defaulted  defaulting  defaults
defaulter N: defaulters
defeat N: defeats
defeat V: defeated  defeating  defeats
defeater N: defeaters
defeatism N: ~defeatisms
defeatist A:
defeatist N: defeatists
defecate V: defecated  defecating  defecates
defecation N: ~defecations
defect N: defects
defect V: defected  defecting  defects
defection N: defections
defective A:
defective N: defectives
defectively A:
defectiveness N: ~defectivenesses
defector N: defectors
defence N: defences
-defence V: defenced  defencing  defences
defend V: defended  defending  defends
-defendant A:
defendant N: defendants
defender N: defenders
defense N: defenses
defense V: defensed  defensing  defenses
defenseless A:
defenselessly A:
defenselessness N: ~defenselessnesses
defensible A:
defensibly A:
defensive A:
defensive N: ~defensives
defensively A:
defensiveness N: ~defensivenesses
defer V: deferred  deferring  defers
deference N: ~deferences
deferential A:
deferentially A:
deferment N: deferments
deferral N: deferrals
defiance N: ~defiances
defiant A:
defiantly A:
deficiency N: deficiencies
deficient A:
-deficient N: deficients
deficit N: deficits
defile N: defiles
defile V: defiled  defiling  defiles
defilement N: ~defilements
defiler N: defilers
definable A:
define V: defined  defining  defines
definer N: definers
definite A:
definitely A:
definiteness N: ~definitenesses
definition N: definitions
definitive A:
-definitive N: definitives
definitively A:
deflate V: deflated  deflating  deflates
deflation N: ~deflations
deflationary A:
deflect V: deflected  deflecting  deflects
deflection N: deflections
deflective A:
deflector N: deflectors
deflower V: deflowered  deflowering  deflowers
defog V: defogged  defogging  defogs
defogger N: defoggers
defoliant N: defoliants
-defoliate A:
defoliate V: defoliated  defoliating  defoliates
defoliation N: ~defoliations
defoliator N: defoliators
deforest V: deforested  deforesting  deforests
deforestation N: ~deforestations
deform V: deformed  deforming  deforms
deformation N: deformations
deformity N: deformities
defraud V: defrauded  defrauding  defrauds
defrauder N: defrauders
defray V: defrayed  defraying  defrays
defrayal N: ~defrayals
defrock V: defrocked  defrocking  defrocks
defrost V: defrosted  defrosting  defrosts
defroster N: defrosters
deft A: defter  deftest
deftly A:
deftness N: ~deftnesses
defunct A:
defuse V: defused  defusing  defuses
defy V: defied  defying  defies
degas V: degassed  degassing  degases
degeneracy N: ~degeneracies
degenerate A:
degenerate N: degenerates
degenerate V: degenerated  degenerating  degenerates
degeneration N: ~degenerations
degenerative A:
degradable A:
degradation N: ~degradations
degrade V: degraded  degrading  degrades
degree N: degrees
dehumanization N: ~dehumanizations
dehumanize V: dehumanized  dehumanizing  dehumanizes
dehumidifier N: dehumidifiers
dehumidify V: dehumidified  dehumidifying  dehumidifies
dehydrate V: dehydrated  dehydrating  dehydrates
dehydration N: ~dehydrations
dehydrator N: dehydrators
dehydrogenate V: dehydrogenated  dehydrogenating  dehydrogenates
deice V: deiced  deicing  deices
deicer N: deicers
deification N: ~deifications
deify V: deified  deifying  deifies
deign V: deigned  deigning  deigns
deism N: ~deisms
deist N: deists
deistic A:
deity N: deities
-deject A:
deject V: dejected  dejecting  dejects
dejectedly A:
dejection N: ~dejections
delay N: delays
delay V: delayed  delaying  delays
delayer N: delayers
delectable A:
-delectable N: delectables
delectably A:
delectation N: ~delectations
delegate N: delegates
delegate V: delegated  delegating  delegates
delegation N: delegations
delete V: deleted  deleting  deletes
deleterious A:
deletion N: deletions
delft N: ~delfts
delftware N: ~delftwares
deli N: delis
deliberate A:
deliberate V: deliberated  deliberating  deliberates
deliberately A:
deliberateness N: ~deliberatenesses
deliberation N: deliberations
deliberative A:
delicacy N: delicacies
delicate A:
-delicate N: delicates
delicately A:
delicateness N: ~delicatenesses
delicatessen N: delicatessens
delicious A:
deliciously A:
deliciousness N: ~deliciousnesses
delight N: delights
delight V: delighted  delighting  delights
delightedly A:
delightful A:
delightfully A:
delimit V: delimited  delimiting  delimits
delimitation N: ~delimitations
delineate A:
delineate V: delineated  delineating  delineates
delineation N: delineations
delinquency N: delinquencies
delinquent A:
delinquent N: delinquents
delinquently A:
deliquesce V: deliquesced  deliquescing  deliquesces
deliquescent A:
delirious A:
deliriously A:
deliriousness N: ~deliriousnesses
delirium N: deliriums (deliria)
deliver V: delivered  delivering  delivers
deliverance N: ~deliverances
deliverer N: deliverers
delivery N: deliveries
deliveryman N: deliverymen
dell N: dells
delouse V: deloused  delousing  delouses
delphinium N: delphiniums (delphinia)
delta N: deltas
delude V: deluded  deluding  deludes
deluge N: deluges
deluge V: deluged  deluging  deluges
delusion N: delusions
delusional A:
delusive A:
delusively A:
deluxe A:
delve V: delved  delving  delves
delver N: delvers
demagnetization N: ~demagnetizations
demagnetize V: demagnetized  demagnetizing  demagnetizes
demagog N: demagogs
-demagog V: demagoged  demagoging  demagogs
demagogic A:
demagogue N: demagogues
-demagogue V: demagogued  demagoguing  demagogues
demagoguery N: ~demagogueries
demagogy N: ~demagogies
demand N: demands
demand V: demanded  demanding  demands
demarcate V: demarcated  demarcating  demarcates
demarcation N: ~demarcations
demean V: demeaned  demeaning  demeans
demeanor N: ~demeanors
demeanour N: ~demeanours
demented A:
dementedly A:
dementia N: ~dementias
demerit N: demerits
demesne N: demesnes
demigod N: demigods
demigoddess N: demigoddesses
demijohn N: demijohns
demilitarization N: ~demilitarizations
demilitarize V: demilitarized  demilitarizing  demilitarizes
demimondaine N: demimondaines
demimonde N: ~demimondes
demise N: demises
demise V: demised  demising  demises
demitasse N: demitasses
demo N: demos
demobilization N: ~demobilizations
demobilize V: demobilized  demobilizing  demobilizes
democracy N: democracies
democrat N: democrats
democratic A:
democratically A:
democratization N: ~democratizations
democratize V: democratized  democratizing  democratizes
demode A:
demodulate V: demodulated  demodulating  demodulates
demodulation N: ~demodulations
demographer N: demographers
demographic A:
demographic N: demographics
demographically A:
demographics N:
demography N: ~demographies
demolish V: demolished  demolishing  demolishes
-demolition A:
demolition N: demolitions
demon N: demons
demonetization N: ~demonetizations
demonetize V: demonetized  demonetizing  demonetizes
demoniac A:
-demoniac N: demoniacs
demoniacal A:
demoniacally A:
demonic A:
demonology N: demonologies
demonstrable A:
demonstrably A:
demonstrate V: demonstrated  demonstrating  demonstrates
demonstration N: demonstrations
demonstrative A:
demonstrative N: demonstratives
demonstratively A:
demonstrativeness N: ~demonstrativenesses
demonstrator N: demonstrators
demoralization N: ~demoralizations
demoralize V: demoralized  demoralizing  demoralizes
demote V: demoted  demoting  demotes
demotic A:
-demotic N: demotics
demotion N: demotions
demulcent A:
demulcent N: demulcents
demur N: ~demurs
demur V: demurred  demurring  demurs
demure A: demurer  demurest
demurely A:
demureness N: ~demurenesses
demurral N: demurrals
demurrer N: demurrers
demystification N: ~demystifications
demystify V: demystified  demystifying  demystifies
den N: dens
-den V: denned  denning  dens
denationalize V: denationalized  denationalizing  denationalizes
denature V: denatured  denaturing  denatures
dendrite N: dendrites
dengue N: ~dengues
deniable A:
denial N: denials
denier N: deniers
denigrate V: denigrated  denigrating  denigrates
denigration N: ~denigrations
denim N: denims
denizen N: denizens
-denizen V: denizened  denizening  denizens
denominate V: denominated  denominating  denominates
denomination N: denominations
denominational A:
denominator N: denominators
denotation N: denotations
denotative A:
denote V: denoted  denoting  denotes
denouement N: denouements
denounce V: denounced  denouncing  denounces
denouncement N: denouncements
dense A: denser  densest
densely A:
denseness N: ~densenesses
density N: densities
dent N: dents
dent V: dented  denting  dents
dental A:
-dental N: dentals
dentally A:
dentifrice N: dentifrices
dentin N: ~dentins
dentine N: ~dentines
dentist N: dentists
dentistry N: ~dentistries
dentition N: ~dentitions
denture N: dentures
denuclearize V: denuclearized  denuclearizing  denuclearizes
denudation N: ~denudations
denude V: denuded  denuding  denudes
denunciation N: denunciations
deny V: denied  denying  denies
deodorant A:
deodorant N: deodorants
deodorization N: ~deodorizations
deodorize V: deodorized  deodorizing  deodorizes
deodorizer N: deodorizers
depart V: departed  departing  departs
departed N: departed
department N: departments
departmental A:
departmentalization N: ~departmentalizations
departmentalize V: departmentalized  departmentalizing  departmentalizes
departmentally A:
departure N: departures
depend V: depended  depending  depends
dependability N: ~dependabilities
dependable A:
dependably A:
dependance N: ~dependances
dependant A:
dependant N: dependants
dependence N: ~dependences
dependency N: dependencies
dependent A:
dependent N: dependents
dependently A:
depersonalize V: depersonalized  depersonalizing  depersonalizes
depict V: depicted  depicting  depicts
depiction N: depictions
depilatory A:
depilatory N: depilatories
deplane V: deplaned  deplaning  deplanes
deplete V: depleted  depleting  depletes
depletion N: ~depletions
deplorable A:
deplorably A:
deplore V: deplored  deploring  deplores
deploy V: deployed  deploying  deploys
deployment N: deployments
depolarization N: ~depolarizations
depolarize V: depolarized  depolarizing  depolarizes
depoliticize V: depoliticized  depoliticizing  depoliticizes
-deponent A:
deponent N: deponents
depopulate V: depopulated  depopulating  depopulates
depopulation N: ~depopulations
deport V: deported  deporting  deports
deportation N: deportations
deportee N: deportees
deportment N: ~deportments
depose V: deposed  deposing  deposes
deposit N: deposits
deposit V: deposited  depositing  deposits
deposition N: depositions
depositor N: depositors
depository A:
depository N: depositories
depot N: depots
deprave V: depraved  depraving  depraves
depravity N: depravities
deprecate V: deprecated  deprecating  deprecates
deprecation N: ~deprecations
deprecatory A:
depreciate V: depreciated  depreciating  depreciates
depreciation N: ~depreciations
depredation N: depredations
depress V: depressed  depressing  depresses
depressant A:
depressant N: depressants
depressingly A:
depression N: depressions
depressive A:
depressive N: depressives
depressor N: depressors
depressurize V: depressurized  depressurizing  depressurizes
deprivation N: deprivations
deprive V: deprived  depriving  deprives
deprogram V: deprogrammed (deprogramed)  deprogramming (deprograming)  deprograms
depth N: depths
deputation N: deputations
depute V: deputed  deputing  deputes
deputize V: deputized  deputizing  deputizes
deputy A:
deputy N: deputies
-derail N: derails
derail V: derailed  derailing  derails
derailleur N: derailleurs
derailment N: derailments
derange V: deranged  deranging  deranges
derangement N: ~derangements
derby N: derbies
deregulate V: deregulated  deregulating  deregulates
deregulation N: ~deregulations
derelict A:
derelict N: derelicts
dereliction N: ~derelictions
deride V: derided  deriding  derides
derision N: ~derisions
derisive A:
derisively A:
derisiveness N: ~derisivenesses
derisory A:
derivation N: derivations
derivative A:
derivative N: derivatives
derive V: derived  deriving  derives
dermal A:
dermatitis N: ~dermatitises / ~dermatitides
dermatological A:
dermatologist N: dermatologists
dermatology N: ~dermatologies
dermis N: ~dermises
-derogate A:
derogate V: derogated  derogating  derogates
derogation N: ~derogations
derogatorily A:
derogatory A:
derrick N: derricks
-derrick V: derricked  derricking  derricks
derriere N: derrieres
derringer N: derringers
dervish N: dervishes
desalinate V: desalinated  desalinating  desalinates
desalination N: ~desalinations
desalinization N: ~desalinizations
desalinize V: desalinized  desalinizing  desalinizes
desalt V: desalted  desalting  desalts
-descant A:
descant N: descants
descant V: descanted  descanting  descants
descend V: descended  descending  descends
descendant A:
descendant N: descendants
descendent A:
descendent N: descendents
descent N: descents
describable A:
describe V: described  describing  describes
describer N: describers
description N: descriptions
descriptive A:
descriptively A:
descriptiveness N: ~descriptivenesses
descry V: descried  descrying  descries
desecrate V: desecrated  desecrating  desecrates
desecration N: ~desecrations
desegregate V: desegregated  desegregating  desegregates
desegregation N: ~desegregations
desensitization N: ~desensitizations
desensitize V: desensitized  desensitizing  desensitizes
desert A:
desert N: deserts
desert V: deserted  deserting  deserts
deserter N: deserters
desertion N: desertions
deserve V: deserved  deserving  deserves
deservedly A:
deshabille N: ~deshabilles
-desiccant A:
desiccant N: desiccants
desiccate V: desiccated  desiccating  desiccates
desiccation N: ~desiccations
desiccator N: desiccators
desideratum N: desiderata
design N: designs
design V: designed  designing  designs
designate A:
designate V: designated  designating  designates
designation N: designations
designer A:
designer N: designers
designing N: ~designings
desirability N: ~desirabilities
desirable A:
-desirable N: desirables
desirableness N: ~desirablenesses
desirably A:
desire N: desires
desire V: desired  desiring  desires
desirous A:
desist V: desisted  desisting  desists
desk A:
desk N: desks
desktop A:
desktop N: desktops
desolate A:
desolate V: desolated  desolating  desolates
desolately A:
desolateness N: ~desolatenesses
desolation N: ~desolations
despair N: despairs
despair V: despaired  despairing  despairs
despairingly A:
despatch N: despatches
despatch V: despatched  despatching  despatches
desperado N: desperadoes (desperados)
desperate A:
-desperate N:
desperately A:
desperateness N: ~desperatenesses
desperation N: ~desperations
despicable A:
despicably A:
despise V: despised  despising  despises
despite C:
-despite N: despites
-despite V: despited  despiting  despites
despoil V: despoiled  despoiling  despoils
despoiler N: despoilers
despoilment N: ~despoilments
despoliation N: ~despoliations
despondence N: ~despondences
despondency N: ~despondencies
despondent A:
despondently A:
despot N: despots
despotic A:
despotically A:
despotism N: ~despotisms
dessert N: desserts
destabilization N: ~destabilizations
destabilize V: destabilized  destabilizing  destabilizes
destination N: destinations
destine V: destined  destining  destines
destiny N: destinies
destitute A:
-destitute V: destituted  destituting  destitutes
destitution N: ~destitutions
destroy V: destroyed  destroying  destroys
destroyer N: destroyers
destruct A:
destruct N: ~destructs
destruct V: destructed  destructing  destructs
destructibility N: ~destructibilities
destructible A:
destruction N: ~destructions
destructive A:
destructively A:
destructiveness N: ~destructivenesses
desuetude N: ~desuetudes
desultorily A:
desultory A:
detach V: detached  detaching  detaches
detachable A:
detachment N: detachments
detail N: details
detail V: detailed  detailing  details
detain V: detained  detaining  detains
detainee N: detainees
detainment N: ~detainments
detect V: detected  detecting  detects
detectable A:
detectible A:
detection N: ~detections
detective A:
detective N: detectives
detector N: detectors
detente N: detentes
detention N: detentions
deter V: deterred  deterring  deters
detergent A:
detergent N: detergents
deteriorate V: deteriorated  deteriorating  deteriorates
deterioration N: ~deteriorations
determent N: ~determents
determinable A:
determinant A:
determinant N: determinants
determinate A:
-determinate V: determinated  determinating  determinates
determination N: determinations
determine V: determined  determining  determines
determinedly A:
determiner N: determiners
determinism N: ~determinisms
deterrence N: ~deterrences
deterrent A:
deterrent N: deterrents
detest V: detested  detesting  detests
detestable A:
detestably A:
detestation N: ~detestations
dethrone V: dethroned  dethroning  dethrones
dethronement N: ~dethronements
detonate V: detonated  detonating  detonates
detonation N: detonations
detonator N: detonators
detour N: detours
detour V: detoured  detouring  detours
detox N: ~detoxes
detox V: detoxed  detoxing  detoxes
detoxification N: ~detoxifications
detoxify V: detoxified  detoxifying  detoxifies
detract V: detracted  detracting  detracts
detraction N: ~detractions
detractor N: detractors
detriment N: detriments
detrimental A:
-detrimental N: detrimentals
detrimentally A:
detritus N: ~detritus
deuce N: deuces
deuterium N: ~deuteriums
devaluation N: devaluations
devalue V: devalued  devaluing  devalues
devastate V: devastated  devastating  devastates
devastatingly A:
devastation N: ~devastations
devastator N: devastators
develop V: developed  developing  develops
developer N: developers
development N: developments
developmental A:
developmentally A:
deviance N: ~deviances
deviancy N: ~deviancies
deviant A:
deviant N: deviants
deviate A:
deviate N: deviates
deviate V: deviated  deviating  deviates
deviation N: deviations
device N: devices
devil N: devils
devil V: deviled (devilled)  deviling (devilling)  devils
devilish A:
devilishly A:
devilishness N: ~devilishnesses
devilment N: ~devilments
devilry N: devilries
deviltry N: deviltries
devious A:
deviously A:
deviousness N: ~deviousnesses
devise N: devises
devise V: devised  devising  devises
devitalize V: devitalized  devitalizing  devitalizes
devoid A:
devolution N: ~devolutions
devolve V: devolved  devolving  devolves
devote V: devoted  devoting  devotes
devotedly A:
devotee N: devotees
devotion N: devotions
devotional A:
devotional N: devotionals
devour V: devoured  devouring  devours
devout A: devouter  devoutest
devoutly A:
devoutness N: ~devoutnesses
dew N: ~dews
-dew V: dewed  dewing  dews
dewberry N: dewberries
dewclaw N: dewclaws
dewdrop N: dewdrops
dewiness N: ~dewinesses
dewlap N: dewlaps
dewy A: dewier  dewiest
dexterity N: ~dexterities
dexterous A:
dexterously A:
dexterousness N: ~dexterousnesses
dextrose N: ~dextroses
dextrous A:
dhoti N: dhotis
dhow N: dhows
diabetes N: ~diabetes
diabetic A:
diabetic N: diabetics
diabolic A:
diabolical A:
diabolically A:
diacritic A:
diacritic N: diacritics
diacritical A:
diadem N: diadems
-diadem V: diademed  diademing  diadems
diaeresis N: diaereses
diagnose V: diagnosed  diagnosing  diagnoses
diagnosis N: diagnoses
diagnostic A:
-diagnostic N: diagnostics
diagnostically A:
diagnostics N:
diagnostician N: diagnosticians
diagonal A:
diagonal N: diagonals
diagonally A:
diagram N: diagrams
diagram V: diagrammed (diagramed)  diagramming (diagraming)  diagrams
diagrammatic A:
diagrammatically A:
dial N: dials
dial V: dialed (dialled)  dialing (dialling)  dials
dialect N: dialects
dialectal A:
dialectic A:
dialectic N: ~dialectics
dialectical A:
dialectics N:
dialog N: dialogs
-dialog V: dialoged  dialoging  dialogs
dialogue N: dialogues
-dialogue V: dialogued  dialoguing  dialogues
dialysis N: dialyses
diameter N: diameters
diametric A:
diametrical A:
diametrically A:
diamond A:
diamond N: diamonds
-diamond V: diamonded  diamonding  diamonds
diamondback N: diamondbacks
diapason N: diapasons
diaper N: diapers
diaper V: diapered  diapering  diapers
diaphanous A:
diaphragm N: diaphragms
-diaphragm V: diaphragmed  diaphragming  diaphragms
diaphragmatic A:
diarist N: diarists
diarrhea N: ~diarrheas
diarrhoea N: ~diarrhoeas
diary N: diaries
diastase N: ~diastases
diastole N: ~diastoles
diastolic A:
diathermy N: ~diathermies
diatom N: diatoms
diatomic A:
diatonic A:
diatribe N: diatribes
dibble N: dibbles
dibble V: dibbled  dibbling  dibbles
dibs N:
dice V: diced  dicing  dices
dicey A: dicier  diciest
dichotomous A:
dichotomy N: dichotomies
dick N: dicks
-dick V: dicked  dicking  dicks
-dicker N: dickers
dicker V: dickered  dickering  dickers
-dickey A: -dickier  -dickiest
dickey N: dickeys
dicky A: -dickier  -dickiest
dicky N: dickies
dicotyledon N: dicotyledons
dicotyledonous A:
dictate N: dictates
dictate V: dictated  dictating  dictates
dictation N: dictations
dictator N: dictators
dictatorial A:
dictatorially A:
dictatorship N: dictatorships
diction N: ~dictions
dictionary N: dictionaries
dictum N: dicta (dictums)
didactic A:
didactically A:
diddle V: diddled  diddling  diddles
diddler N: diddlers
dido N: didoes / didos
die N: dice {gambling} | dies {tool}
die V: died  dying {expire} | -dieing {shape}  dies
diehard A:
diehard N: diehards
dielectric A:
dielectric N: dielectrics
dieresis N: diereses
diesel A:
diesel N: diesels
diesel V: dieseled  dieseling  diesels
diet A:
diet N: diets
diet V: dieted  dieting  diets
dietary A:
dietary N: dietaries
dieter N: dieters
dietetic A:
dietetics N:
dietician N: dieticians
dietitian N: dietitians
differ V: differed  differing  differs
difference N: differences
-difference V: differenced  differencing  differences
different A:
differential A:
differential N: differentials
differentiate V: differentiated  differentiating  differentiates
differentiation N: ~differentiations
differently A:
difficult A:
difficultly A:
difficulty N: difficulties
diffidence N: ~diffidences
diffident A:
diffidently A:
diffraction N: ~diffractions
diffuse A:
diffuse V: diffused  diffusing  diffuses
diffusely A:
diffuseness N: ~diffusenesses
diffusion N: ~diffusions
diffusive A:
dig N: digs
dig V: dug (-@digged)  digging  digs
digerati N:
digest N: digests
digest V: digested  digesting  digests
digestibility N: ~digestibilities
digestible A:
digestion N: digestions
digestive A:
-digestive N: digestives
digger N: diggers
diggings N:
digit N: digits
digital A:
-digital N: digitals
digitalis N: ~digitalises
digitally A:
digitize V: digitized  digitizing  digitizes
dignify V: dignified  dignifying  dignifies
dignitary N: dignitaries
dignity N: dignities
digraph N: digraphs
digress V: digressed  digressing  digresses
digression N: digressions
digressive A:
dike N: dikes
dike V: diked  diking  dikes
dilapidated A:
dilapidation N: ~dilapidations
dilatation N: ~dilatations
dilate V: dilated  dilating  dilates
dilation N: ~dilations
dilator N: dilators
dilatory A:
dilemma N: dilemmas
dilettante A:
dilettante N: dilettantes (dilettanti)
dilettantish A:
dilettantism N: ~dilettantisms
diligence N: ~diligences
diligent A:
diligently A:
dill N: dills
dilly N: dillies
dillydally V: dillydallied  dillydallying  dillydallies
dilute A:
dilute V: diluted  diluting  dilutes
dilution N: ~dilutions
dim A: dimmer  dimmest
dim V: dimmed  dimming  dims
dime N: dimes
dimension N: dimensions
-dimension V: dimensioned  dimensioning  dimensions
dimensional A:
diminish V: diminished  diminishing  diminishes
diminuendo A:
diminuendo N: diminuendos / diminuendoes
diminution N: diminutions
diminutive A:
diminutive N: diminutives
dimity N: ~dimities
dimly A:
dimmer N: dimmers
dimness N: ~dimnesses
dimple N: dimples
dimple V: dimpled  dimpling  dimples
dimpled A:
dimply A: -dimplier  -dimpliest
dimwit N: dimwits
dimwitted A:
din N: dins
din V: dinned  dinning  dins
dinar N: dinars
dine V: dined  dining  dines
diner N: diners
dinette N: dinettes
ding N: dings
ding V: dinged  dinging  dings
dingbat N: dingbats
-dingdong A:
dingdong N: ~dingdongs
dinghy N: dinghies
dingily A:
dinginess N: ~dinginesses
dingle N: dingles
dingo N: dingoes
dingus N: dinguses
dingy A: dingier  dingiest
dinky A: dinkier  dinkiest
dinky N: dinkies
dinner N: dinners
dinner V: dinnered  dinnering  dinners
dinnertime N: ~dinnertimes
dinnerware N: ~dinnerwares
dinosaur N: dinosaurs
dint N: ~dints
-dint V: dinted  dinting  dints
diocesan A:
diocesan N: diocesans
diocese N: dioceses
diode N: diodes
diorama N: dioramas
dioxide N: dioxides
dioxin N: dioxins
dip N: dips
dip V: dipped  dipping  dips
diphtheria N: ~diphtherias
diphthong N: diphthongs
-diphthong V: diphthonged  diphthonging  diphthongs
diploid A:
diploid N: diploids
diploma N: diplomas | diplomata {historical document}
-diploma V: diplomaed  diplomaing  diplomas
diplomacy N: ~diplomacies
diplomat N: diplomats
diplomatic A:
diplomatically A:
diplomatist N: diplomatists
dipole N: dipoles
dipper N: dippers
dippy A: dippier  dippiest
dipsomania N: ~dipsomanias
dipsomaniac N: dipsomaniacs
dipstick N: dipsticks
dipterous A:
diptych N: diptychs
dire A: direr  direst
direct A: directer  directest
direct V: directed  directing  directs
direction N: directions
directional A:
directive A:
directive N: directives
directly A:
directness N: ~directnesses
director N: directors
directorate N: directorates
directorial A:
directorship N: directorships
-directory A:
directory N: directories
direful A:
direly A:
dirge N: dirges
-dirigible A:
dirigible N: dirigibles
dirk N: dirks
-dirk V: dirked  dirking  dirks
dirndl N: dirndls
dirt N: ~dirts
dirtily A:
dirtiness N: ~dirtinesses
dirty A: dirtier  dirtiest
dirty V: dirtied  dirtying  dirties
dis N: ~disses
dis V: dissed  dissing  disses
disability N: disabilities
disable V: disabled  disabling  disables
disablement N: ~disablements
disabuse V: disabused  disabusing  disabuses
disadvantage N: disadvantages
disadvantage V: disadvantaged  disadvantaging  disadvantages
disadvantageous A:
disadvantageously A:
disaffect V: disaffected  disaffecting  disaffects
disaffection N: ~disaffections
disaffiliate V: disaffiliated  disaffiliating  disaffiliates
disaffiliation N: ~disaffiliations
disagree V: disagreed  disagreeing  disagrees
disagreeable A:
-disagreeable N: disagreeables
disagreeableness N: ~disagreeablenesses
disagreeably A:
disagreement N: disagreements
disallow V: disallowed  disallowing  disallows
disappear V: disappeared  disappearing  disappears
disappearance N: disappearances
disappoint V: disappointed  disappointing  disappoints
disappointingly A:
disappointment N: disappointments
disapprobation N: ~disapprobations
disapproval N: ~disapprovals
disapprove V: disapproved  disapproving  disapproves
disapprovingly A:
disarm V: disarmed  disarming  disarms
disarmament N: ~disarmaments
disarmingly A:
disarrange V: disarranged  disarranging  disarranges
disarrangement N: ~disarrangements
disarray N: ~disarrays
disarray V: disarrayed  disarraying  disarrays
disassemble V: disassembled  disassembling  disassembles
disassociate V: disassociated  disassociating  disassociates
disassociation N: ~disassociations
disaster N: disasters
disastrous A:
disastrously A:
disavow V: disavowed  disavowing  disavows
disavowal N: disavowals
disband V: disbanded  disbanding  disbands
disbandment N: ~disbandments
disbar V: disbarred  disbarring  disbars
disbarment N: ~disbarments
disbelief N: ~disbeliefs
disbelieve V: disbelieved  disbelieving  disbelieves
disbeliever N: disbelievers
disbelievingly A:
disbursal N: ~disbursals
disburse V: disbursed  disbursing  disburses
disbursement N: disbursements
disc N: discs
-disc V: disced  discing  discs
discard N: discards
discard V: discarded  discarding  discards
discern V: discerned  discerning  discerns
discernible A:
discernibly A:
discerningly A:
discernment N: ~discernments
discharge N: discharges
discharge V: discharged  discharging  discharges
disciple N: disciples
-disciple V: discipled  discipling  disciples
discipleship N: ~discipleships
disciplinarian A:
disciplinarian N: disciplinarians
disciplinary A:
discipline N: disciplines
discipline V: disciplined  disciplining  disciplines
disclaim V: disclaimed  disclaiming  disclaims
disclaimer N: disclaimers
disclose V: disclosed  disclosing  discloses
disclosure N: disclosures
disco A:
disco N: discos
disco V: discoed  discoing  discos
discography N: discographies
discolor V: discolored  discoloring  discolors
discoloration N: discolorations
discolour V: discoloured  discolouring  discolours
discombobulate V: discombobulated  discombobulating  discombobulates
discombobulation N: ~discombobulations
-discomfit N: discomfits
discomfit V: discomfited  discomfiting  discomfits
discomfiture N: ~discomfitures
discomfort N: discomforts
discomfort V: discomforted  discomforting  discomforts
discommode V: discommoded  discommoding  discommodes
discompose V: discomposed  discomposing  discomposes
discomposure N: ~discomposures
disconcert V: disconcerted  disconcerting  disconcerts
disconcertingly A:
disconnect V: disconnected  disconnecting  disconnects
disconnectedly A:
disconnectedness N: ~disconnectednesses
disconnection N: disconnections
disconsolate A:
disconsolately A:
discontent A:
discontent N: ~discontents
discontent V: discontented  discontenting  discontents
discontentedly A:
discontentment N: ~discontentments
discontinuance N: discontinuances
discontinuation N: discontinuations
discontinue V: discontinued  discontinuing  discontinues
discontinuity N: discontinuities
discontinuous A:
discontinuously A:
discord N: discords
discord V: discorded  discording  discords
discordance N: ~discordances
discordant A:
discordantly A:
discotheque N: discotheques
discount A:
discount N: discounts
discount V: discounted  discounting  discounts
-discountenance N: discountenances
discountenance V: discountenanced  discountenancing  discountenances
discounter N: discounters
discourage V: discouraged  discouraging  discourages
discouragement N: discouragements
discouragingly A:
discourse N: discourses
discourse V: discoursed  discoursing  discourses
discourteous A:
discourteously A:
discourtesy N: discourtesies
discover V: discovered  discovering  discovers
discoverer N: discoverers
discovery N: discoveries
discredit N: ~discredits
discredit V: discredited  discrediting  discredits
discreditable A:
discreditably A:
discreet A: discreeter  discreetest
discreetly A:
discreetness N: ~discreetnesses
discrepancy N: discrepancies
discrepant A:
discrete A: -discreter  -discretest
discretely A:
discreteness N: ~discretenesses
discretion N: ~discretions
discretionary A:
-discriminate A:
discriminate V: discriminated  discriminating  discriminates
discrimination N: ~discriminations
discriminator N: discriminators
discriminatory A:
discursive A:
discursively A:
discursiveness N: ~discursivenesses
discus N: discuses (-disci)
discuss V: discussed  discussing  discusses
discussant N: discussants
discussion N: discussions
disdain N: ~disdains
disdain V: disdained  disdaining  disdains
disdainful A:
disdainfully A:
disease N: diseases
-disease V: diseased  diseasing  diseases
diseased A:
disembark V: disembarked  disembarking  disembarks
disembarkation N: ~disembarkations
disembodiment N: ~disembodiments
disembody V: disembodied  disembodying  disembodies
disembowel V: disemboweled (disembowelled)  disemboweling (disembowelling)  disembowels
disembowelment N: ~disembowelments
disenchant V: disenchanted  disenchanting  disenchants
disenchantment N: ~disenchantments
disencumber V: disencumbered  disencumbering  disencumbers
disenfranchise V: disenfranchised  disenfranchising  disenfranchises
disenfranchisement N: ~disenfranchisements
disengage V: disengaged  disengaging  disengages
disengagement N: disengagements
disentangle V: disentangled  disentangling  disentangles
disentanglement N: ~disentanglements
disequilibrium N: ~disequilibriums (~disequilibria)
disestablish V: disestablished  disestablishing  disestablishes
disestablishment N: ~disestablishments
disesteem N: ~disesteems
disesteem V: disesteemed  disesteeming  disesteems
disfavor N: disfavors
disfavor V: disfavored  disfavoring  disfavors
disfavour N: disfavours
disfigure V: disfigured  disfiguring  disfigures
disfigurement N: disfigurements
disfranchise V: disfranchised  disfranchising  disfranchises
disfranchisement N: ~disfranchisements
disgorge V: disgorged  disgorging  disgorges
disgorgement N: ~disgorgements
disgrace N: disgraces
disgrace V: disgraced  disgracing  disgraces
disgraceful A:
disgracefully A:
disgracefulness N: ~disgracefulnesses
disgruntle V: disgruntled  disgruntling  disgruntles
disgruntlement N: ~disgruntlements
disguise N: disguises
disguise V: disguised  disguising  disguises
disgust N: ~disgusts
disgust V: disgusted  disgusting  disgusts
disgustedly A:
disgustingly A:
dish N: dishes
dish V: dished  dishing  dishes
dishabille N: ~dishabilles
disharmonious A:
disharmony N: ~disharmonies
dishcloth N: dishcloths
dishearten V: disheartened  disheartening  disheartens
dishearteningly A:
dishevel V: disheveled (dishevelled)  disheveling (dishevelling)  dishevels
dishevelment N: ~dishevelments
dishonest A:
dishonestly A:
dishonesty N: ~dishonesties
dishonor N: dishonors
dishonor V: dishonored  dishonoring  dishonors
dishonorable A:
dishonorably A:
dishpan N: dishpans
dishrag N: dishrags
dishtowel N: dishtowels
dishware N: ~dishwares
dishwasher N: dishwashers
dishwater N: ~dishwaters
disillusion N: ~disillusions
disillusion V: disillusioned  disillusioning  disillusions
disillusionment N: ~disillusionments
disinclination N: ~disinclinations
disincline V: disinclined  disinclining  disinclines
disinfect V: disinfected  disinfecting  disinfects
disinfectant A:
disinfectant N: disinfectants
disinfection N: ~disinfections
disinflation N: ~disinflations
disinformation N: ~disinformations
disingenuous A:
disingenuously A:
disinherit V: disinherited  disinheriting  disinherits
disinheritance N: ~disinheritances
disintegrate V: disintegrated  disintegrating  disintegrates
disintegration N: ~disintegrations
disinter V: disinterred  disinterring  disinters
disinterest N: disinterests
-disinterest V: disinterested  disinteresting  disinterests
disinterested A:
disinterestedly A:
disinterestedness N: ~disinterestednesses
disinterment N: ~disinterments
disinvestment N: ~disinvestments
-disjoint A:
disjoint V: disjointed  disjointing  disjoints
disjointedly A:
disjointedness N: ~disjointednesses
disjunctive A:
-disjunctive N: disjunctives
disk N: disks
-disk V: disked  disking  disks
diskette N: diskettes
dislike N: dislikes
dislike V: disliked  disliking  dislikes
dislocate V: dislocated  dislocating  dislocates
dislocation N: dislocations
dislodge V: dislodged  dislodging  dislodges
disloyal A:
disloyally A:
disloyalty N: ~disloyalties
dismal A: -dismaler / -dismaller  -dismalest / -dismallest
-dismal N: dismals
dismally A:
dismantle V: dismantled  dismantling  dismantles
dismantlement N: ~dismantlements
dismay N: ~dismays
dismay V: dismayed  dismaying  dismays
dismember V: dismembered  dismembering  dismembers
dismemberment N: ~dismemberments
dismiss V: dismissed  dismissing  dismisses
dismissal N: dismissals
dismissive A:
dismissively A:
dismount N: dismounts
dismount V: dismounted  dismounting  dismounts
disobedience N: ~disobediences
disobedient A:
disobediently A:
disobey V: disobeyed  disobeying  disobeys
disoblige V: disobliged  disobliging  disobliges
disorder N: disorders
disorder V: disordered  disordering  disorders
disorderliness N: ~disorderlinesses
disorderly A:
disorganization N: ~disorganizations
disorganize V: disorganized  disorganizing  disorganizes
disorient V: disoriented  disorienting  disorients
disorientate V: disorientated  disorientating  disorientates
disorientation N: ~disorientations
disown V: disowned  disowning  disowns
disparage V: disparaged  disparaging  disparages
disparagement N: ~disparagements
disparagingly A:
disparate A:
disparately A:
disparity N: disparities
dispassion N: ~dispassions
dispassionate A:
dispassionately A:
dispatch N: dispatches
dispatch V: dispatched  dispatching  dispatches
dispatcher N: dispatchers
dispel V: dispelled  dispelling  dispels
dispensable A:
dispensary N: dispensaries
dispensation N: dispensations
dispense V: dispensed  dispensing  dispenses
dispenser N: dispensers
dispersal N: ~dispersals
-disperse A:
disperse V: dispersed  dispersing  disperses
dispersion N: ~dispersions
dispirit V: dispirited  dispiriting  dispirits
displace V: displaced  displacing  displaces
displacement N: displacements
display N: displays
display V: displayed  displaying  displays
displease V: displeased  displeasing  displeases
displeasure N: ~displeasures
-displeasure V: displeasured  displeasuring  displeasures
-disport N: disports
disport V: disported  disporting  disports
disposable A:
disposable N: disposables
disposal N: disposals
-dispose N: disposes
dispose V: disposed  disposing  disposes
disposer N: disposers
disposition N: dispositions
dispossess V: dispossessed  dispossessing  dispossesses
dispossession N: ~dispossessions
dispraise N: ~dispraises
dispraise V: dispraised  dispraising  dispraises
disproof N: disproofs
disproportion N: disproportions
-disproportion V: disproportioned  disproportioning  disproportions
disproportional A:
disproportionate A:
disproportionately A:
disprovable A:
disprove V: disproved  disproved (disproven)  disproving  disproves
disputable A:
disputably A:
disputant A:
disputant N: disputants
disputation N: disputations
disputatious A:
disputatiously A:
dispute N: disputes
dispute V: disputed  disputing  disputes
disputer N: disputers
disqualification N: disqualifications
disqualify V: disqualified  disqualifying  disqualifies
-disquiet A:
disquiet N: ~disquiets
disquiet V: disquieted  disquieting  disquiets
disquietude N: ~disquietudes
disquisition N: disquisitions
disregard N: ~disregards
disregard V: disregarded  disregarding  disregards
disregardful A:
disrepair N: ~disrepairs
disreputable A:
disreputably A:
disrepute N: ~disreputes
disrespect N: ~disrespects
disrespect V: disrespected  disrespecting  disrespects
disrespectful A:
disrespectfully A:
disrobe V: disrobed  disrobing  disrobes
disrupt V: disrupted  disrupting  disrupts
disruption N: disruptions
disruptive A:
disruptively A:
diss V: dissed  dissing  disses
dissatisfaction N: ~dissatisfactions
dissatisfy V: dissatisfied  dissatisfying  dissatisfies
dissect V: dissected  dissecting  dissects
dissection N: dissections
dissector N: dissectors
dissemblance N: ~dissemblances
dissemble V: dissembled  dissembling  dissembles
dissembler N: dissemblers
disseminate V: disseminated  disseminating  disseminates
dissemination N: ~disseminations
dissension N: dissensions
dissent N: dissents
dissent V: dissented  dissenting  dissents
dissenter N: dissenters
dissertation N: dissertations
disservice N: disservices
dissever V: dissevered  dissevering  dissevers
dissidence N: ~dissidences
dissident A:
dissident N: dissidents
dissimilar A:
dissimilarity N: dissimilarities
dissimilitude N: dissimilitudes
dissimulate V: dissimulated  dissimulating  dissimulates
dissimulation N: ~dissimulations
dissimulator N: dissimulators
dissipate V: dissipated  dissipating  dissipates
dissipation N: ~dissipations
dissociate V: dissociated  dissociating  dissociates
dissociation N: ~dissociations
dissoluble A:
dissolute A:
dissolutely A:
dissoluteness N: ~dissolutenesses
dissolution N: ~dissolutions
-dissolve N: dissolves
dissolve V: dissolved  dissolving  dissolves
dissonance N: dissonances
dissonant A:
dissuade V: dissuaded  dissuading  dissuades
dissuasion N: ~dissuasions
dissuasive A:
distaff A:
distaff N: distaffs
distal A:
distally A:
distance N: distances
distance V: distanced  distancing  distances
distant A:
distantly A:
distaste N: distastes
-distaste V: distasted  distasting  distastes
distasteful A:
distastefully A:
distastefulness N: ~distastefulnesses
distemper N: ~distempers
-distemper V: distempered  distempering  distempers
distend V: distended  distending  distends
distension N: distensions
distention N: distentions
distil V: distilled  distilling  distils
distill V: distilled  distilling  distills
distillate N: distillates
distillation N: distillations
distiller N: distillers
distillery N: distilleries
distinct A: distincter  distinctest
distinction N: distinctions
distinctive A:
distinctively A:
distinctiveness N: ~distinctivenesses
distinctly A:
distinctness N: ~distinctnesses
distinguish V: distinguished  distinguishing  distinguishes
distinguishable A:
distort V: distorted  distorting  distorts
distortion N: distortions
distract V: distracted  distracting  distracts
distractedly A:
distraction N: distractions
distrait A:
distraught A:
distress N: ~distresses
distress V: distressed  distressing  distresses
distressful A:
distressingly A:
distribute V: distributed  distributing  distributes
distribution N: distributions
distributive A:
-distributive N: distributives
distributively A:
distributor N: distributors
district N: districts
-district V: districted  districting  districts
distrust N: ~distrusts
distrust V: distrusted  distrusting  distrusts
distrustful A:
distrustfully A:
disturb V: disturbed  disturbing  disturbs
disturbance N: disturbances
disturber N: disturbers
disunion N: ~disunions
disunite V: disunited  disuniting  disunites
disunity N: ~disunities
disuse N: ~disuses
disuse V: disused  disusing  disuses
ditch N: ditches
ditch V: ditched  ditching  ditches
dither N: dithers
dither V: dithered  dithering  dithers
ditherer N: ditherers
ditsy A: !ditsier  !ditsiest
ditto A:
ditto I:
ditto N: dittos (dittoes)
ditto V: dittoed  dittoing  dittos / dittoes
ditty N: ditties
-ditty V: dittied  dittying  ditties
ditz N: ditzes
ditzy A: ditzier  ditziest
diuretic A:
diuretic N: diuretics
diurnal A:
-diurnal N: diurnals
diurnally A:
diva N: divas
divalent A:
divan N: divans
dive N: dives
dive V: dived (dove)  dived  diving  dives
diver N: divers
diverge V: diverged  diverging  diverges
divergence N: divergences
divergent A:
divers A:
diverse A:
diversely A:
diverseness N: ~diversenesses
diversification N: ~diversifications
diversify V: diversified  diversifying  diversifies
diversion N: diversions
diversionary A:
diversity N: diversities
divert V: diverted  diverting  diverts
diverticulitis N: ~diverticulitises
divest V: divested  divesting  divests
divestiture N: divestitures
divestment N: ~divestments
dividable A:
divide N: divides
divide V: divided  dividing  divides
dividend N: dividends
divider N: dividers
divination N: ~divinations
divine A: diviner  divinest
divine N: divines
divine V: divined  divining  divines
divinely A:
diviner N: diviners
diving N: ~divings
divinity N: divinities
divisibility N: ~divisibilities
divisible A:
division N: divisions
divisional A:
divisive A:
divisively A:
divisiveness N: ~divisivenesses
divisor N: divisors
divorce N: divorces
divorce V: divorced  divorcing  divorces
divorcee N: divorcees
divorcement N: divorcements
divot N: divots
divulge V: divulged  divulging  divulges
divvy N: divvies
divvy V: divvied  divvying  divvies
dixieland N: ~dixielands
dizzily A:
dizziness N: ~dizzinesses
dizzy A: dizzier  dizziest
dizzy V: dizzied  dizzying  dizzies
djellaba N: djellabas
djellabah N: djellabahs
djinn N: djinns (djinn)
do N: dos (-do's)
do V: did done  doing  does 
doable A:
dobbin N: dobbins
doberman N: dobermans
doc N: docs
docent N: docents
docile A: -dociler  -docilest
docilely A:
docility N: ~docilities
dock N: docks
dock V: docked  docking  docks
docket N: dockets
docket V: docketed  docketing  dockets
dockworker N: dockworkers
dockyard N: dockyards
doctor N: doctors
doctor V: doctored  doctoring  doctors
doctoral A:
doctorate N: doctorates
doctrinaire A:
doctrinaire N: doctrinaires
doctrinal A:
doctrine N: doctrines
docudrama N: docudramas
document N: documents
document V: documented  documenting  documents
documentary A:
documentary N: documentaries
documentation N: ~documentations
dodder N: dodders
dodder V: doddered  doddering  dodders
dodge N: dodges
dodge V: dodged  dodging  dodges
dodger N: dodgers
dodo N: dodos (dodoes)
doe N: doe | does
doer N: doers
doeskin N: doeskins
doff V: doffed  doffing  doffs
dog N: dogs
dog V: dogged  dogging  dogs
dogcart N: dogcarts
dogcatcher N: dogcatchers
doge N: doges
dogear N: dogears
dogear V: dogeared  dogearing  dogears
dogfight N: dogfights
dogfish N: dogfishes | dogfish
dogged A: -doggeder  -doggedest
doggedly A:
doggedness N: ~doggednesses
doggerel N: ~doggerels
doggie N: doggies
doggone A: doggoner  doggonest
doggone I:
doggone V: doggoned  doggoning  doggones
doggoned A: doggoneder  doggonedest
doggy A: doggier  doggiest
doggy N: doggies
doghouse N: doghouses
dogie N: dogies
dogleg A:
dogleg N: doglegs
dogleg V: doglegged  doglegging  doglegs
dogma N: dogmas (dogmata)
dogmatic A:
dogmatically A:
dogmatism N: ~dogmatisms
dogmatist N: dogmatists
dogtrot N: dogtrots
dogtrot V: dogtrotted  dogtrotting  dogtrots
dogwood A:
dogwood N: dogwoods
dogy N: dogies
doh N: ~dohs
doily N: doilies
doing N: doings
doldrums N:
dole N: doles
dole V: doled  doling  doles
doleful A: -dolefuller  -dolefullest
dolefully A:
dolefulness N: ~dolefulnesses
doll N: dolls
doll V: dolled  dolling  dolls
dollar N: dollars
dollhouse N: dollhouses
dollop N: dollops
dollop V: dolloped  dolloping  dollops
dolly N: dollies
-dolly V: dollied  dollying  dollies
dolmen N: dolmens
dolomite N: ~dolomites
dolor N: ~dolors
dolorous A:
dolorously A:
dolphin N: dolphins
dolt N: dolts
doltish A:
doltishly A:
doltishness N: ~doltishnesses
domain N: domains
dome N: domes
dome V: domed  doming  domes
domestic A:
domestic N: domestics
domestically A:
domesticate V: domesticated  domesticating  domesticates
domestication N: ~domestications
domesticity N: ~domesticities
domicile N: domiciles
domicile V: domiciled  domiciling  domiciles
domiciliary A:
dominance N: ~dominances
dominant A:
dominant N: dominants
dominantly A:
dominate V: dominated  dominating  dominates
domination N: ~dominations
dominatrix N: dominatrices (dominatrixes)
domineer V: domineered  domineering  domineers
domineeringly A:
dominion N: dominions
domino N {game}: dominoes
domino N {mask}: dominoes (dominos)
don N: dons
don V: donned  donning  dons
dona N: donas
donate V: donated  donating  donates
donation N: donations
done I:
dong N: dong {money} | dongs {penis}
dongle N: dongles
donkey N: donkeys
donnybrook N: donnybrooks
donor A:
donor N: donors
donut N: donuts
doodad N: doodads
doodle N: doodles
doodle V: doodled  doodling  doodles
doodlebug N: doodlebugs
doodler N: doodlers
doohickey N: doohickeys
doom N: ~dooms
doom V: doomed  dooming  dooms
doomsayer N: doomsayers
doomsday N: ~doomsdays
door N: doors
doorbell N: doorbells
doorkeeper N: doorkeepers
doorknob N: doorknobs
doorman N: doormen
doormat N: doormats
doorplate N: doorplates
doorstep N: doorsteps
doorstep V: doorstepped  doorstepping  doorsteps
doorstop N: doorstops
doorway N: doorways
dooryard N: dooryards
dopa N: ~dopas
dope A:
dope N: dopes
dope V: doped  doping  dopes
doper N: dopers
dopey A: dopier  dopiest
dopiness N: ~dopinesses
doping N: ~dopings
dopy A: dopier  dopiest
dork N: dorks
dorky A: dorkier  dorkiest
dorm N: dorms
dormancy N: ~dormancies
dormant A:
dormer N: dormers
dormitory A:
dormitory N: dormitories
dormouse N: dormice
dorsal A:
dorsally A:
dory N: dories
dosage N: dosages
dose N: doses
dose V: dosed  dosing  doses
dosimeter N: dosimeters
dossier N: dossiers
dot N: dots
dot V: dotted  dotting  dots
dotage N: ~dotages
dotard N: dotards
dote V: doted  doting  dotes
doter N: doters
dotingly A:
dotty A: dottier  dottiest
double A:
double N: doubles
double V: doubled  doubling  doubles
doubleheader N: doubleheaders
doublespeak N: ~doublespeaks
doublet N: doublets
doubloon N: doubloons
doubly A:
doubt N: doubts
doubt V: doubted  doubting  doubts
doubter N: doubters
doubtful A: doubtfuller  doubtfullest
doubtfully A:
doubtfulness N: ~doubtfulnesses
doubtingly A:
doubtless A:
doubtlessly A:
douche N: douches
douche V: douched  douching  douches
dough N: ~doughs
doughnut N: doughnuts
doughty A: doughtier  doughtiest
doughy A: doughier  doughiest
dour A: dourer  dourest
dourly A:
dourness N: ~dournesses
-douse N: douses
douse V: doused  dousing  douses
dove N: doves
dovecote N: dovecotes
dovetail N: dovetails
dovetail V: dovetailed  dovetailing  dovetails
dovish A:
dowager A:
dowager N: dowagers
dowdily A:
dowdiness N: ~dowdinesses
dowdy A: dowdier  dowdiest
dowel N: dowels
dowel V: doweled (dowelled)  doweling (dowelling)  dowels
dower N: dowers
dower V: dowered  dowering  dowers
down A:
down C:
down I:
down N: downs
down V: downed  downing  downs
downbeat A:
downbeat N: downbeats
downcast A:
-downcast N: downcasts
downdraft N: downdrafts
downer N: downers
downfall N: downfalls
downfallen A:
downgrade A:
downgrade N: downgrades
downgrade V: downgraded  downgrading  downgrades
downhearted A:
downheartedly A:
downheartedness N: ~downheartednesses
downhill A:
downhill N: downhills
download N: downloads
download V: downloaded  downloading  downloads
downplay V: downplayed  downplaying  downplays
downpour N: downpours
downrange A:
downright A:
downriver A:
downscale A:
downscale V: downscaled  downscaling  downscales
downshift V: downshifted  downshifting  downshifts
downside N: downsides
downsize V: downsized  downsizing  downsizes
downsizing N: ~downsizings
downspout N: downspouts
downstage A:
-downstage N: downstages
downstairs A:
downstairs N:
downstate A:
downstate N: ~downstates
downstream A:
downswing N: downswings
downtime N: ~downtimes
downtown A:
downtown N: ~downtowns
downtrend N: downtrends
downtrodden A:
downturn N: downturns
downward A:
downwards A:
downwind A:
downy A: downier  downiest
dowry N: dowries
-dowse N: dowses
dowse V: dowsed  dowsing  dowses
dowser N: dowsers
doxology N: doxologies
doyen N: doyens
doyenne N: doyennes
doze N: dozes
doze V: dozed  dozing  dozes
dozen A:
dozen N: dozens | dozen {counting}
-dozen V: dozened  dozening  dozens
dozenth A:
drab A: drabber  drabbest
drab N: drabs
-drab V: drabbed  drabbing  drabs
drably A:
drabness N: ~drabnesses
drachma N: drachmas (drachmae drachmai)
draconian A:
draft A:
draft N: drafts
draft V: drafted  drafting  drafts
draftee N: draftees
drafter N: drafters
draftily A:
draftiness N: ~draftinesses
drafting N: ~draftings
draftsman N: draftsmen
draftsmanship N: ~draftsmanships
draftswoman N: draftswomen
drafty A: draftier  draftiest
drag A:
drag N: drags
drag V: dragged  dragging  drags
draggy A: draggier  draggiest
dragnet N: dragnets
dragon N: dragons
dragonfly N: dragonflies
dragoon N: dragoons
dragoon V: dragooned  dragooning  dragoons
drain N: drains
drain V: drained  draining  drains
drainage N: ~drainages
drainboard N: drainboards
drainer N: drainers
drainpipe N: drainpipes
drake N: drakes
dram N: drams
-dram V: drammed  dramming  drams
drama N: dramas
dramatic A:
dramatically A:
dramatics N:
dramatist N: dramatists
dramatization N: dramatizations
dramatize V: dramatized  dramatizing  dramatizes
drape N: drapes
drape V: draped  draping  drapes
draper N: drapers
drapery N: draperies
drastic A:
drastically A:
drat I:
-drat V: dratted  dratting  drats
draught A:
draught N: draughts
draught V: draughted  draughting  draughts
draughtsman N: draughtsmen
draughty A: draughtier  draughtiest
draw N: draws
draw V: drew  drawn  drawing  draws
drawback N: drawbacks
drawbridge N: drawbridges
drawer N: drawers
drawing N: drawings
drawl N: drawls
drawl V: drawled  drawling  drawls
drawstring N: drawstrings
dray N: drays
-dray V: drayed  draying  drays
dread A:
dread N: ~dreads
dread V: dreaded  dreading  dreads
dreadful A:
-dreadful N: dreadfuls
dreadfully A:
dreadfulness N: ~dreadfulnesses
dreadlocks N:
dreadnaught N: dreadnaughts
dreadnought N: dreadnoughts
dream A:
dream N: dreams
dream V: dreamed (dreamt)  dreaming  dreams
dreamboat N: dreamboats
dreamer N: dreamers
dreamily A:
dreaminess N: ~dreaminesses
dreamland N: ~dreamlands
dreamless A:
dreamlike A:
dreamworld N: dreamworlds
dreamy A: dreamier  dreamiest
drear A: -drearer  -drearest
drearily A:
dreariness N: ~drearinesses
dreary A: drearier  dreariest
dredge N: dredges
dredge V: dredged  dredging  dredges
dredger N: dredgers
dregs N:
-drench N: drenches
drench V: drenched  drenching  drenches
dress A:
dress N: dresses
dress V: dressed (drest)  dressing  dresses
dressage N: ~dressages
dresser N: dressers
dressiness N: ~dressinesses
dressing N: dressings
dressmaker A:
dressmaker N: dressmakers
dressmaking N: ~dressmakings
dressy A: dressier  dressiest
dribble N: dribbles
dribble V: dribbled  dribbling  dribbles
dribbler N: dribblers
driblet N: driblets
drier N: driers
drift N: drifts
drift V: drifted  drifting  drifts
drifter N: drifters
driftwood N: ~driftwoods
drill N: drills
drill V: drilled  drilling  drills
driller N: drillers
drillmaster N: drillmasters
drily A:
drink N: drinks
drink V: drank  drunk (drank)  drinking  drinks
drinkable A:
-drinkable N: drinkables
drinker N: drinkers
drip N: drips
drip V: dripped (dript)  dripping  drips
dripping N: drippings
drippy A: drippier  drippiest
drive N: drives
drive V: drove  driven  driving  drives
drivel N: ~drivels
drivel V: driveled (drivelled)  driveling (drivelling)  drivels
driveler N: drivelers
driver N: drivers
driveway N: driveways
drizzle N: ~drizzles
drizzle V: drizzled  drizzling  drizzles
drizzly A: !drizzlier  !drizzliest
drogue N: drogues
droll A: droller  drollest
-droll V: drolled  drolling  drolls
drollery N: drolleries
drollness N: ~drollnesses
drolly A:
dromedary N: dromedaries
drone N: drones
drone V: droned  droning  drones
drool N: ~drools
drool V: drooled  drooling  drools
droop N: droops
droop V: drooped  drooping  droops
droopiness N: ~droopinesses
droopy A: droopier  droopiest
drop N: drops
drop V: dropped  dropping  drops
dropkick N: dropkicks
droplet N: droplets
dropout N: dropouts
dropper N: droppers
droppings N:
dropsical A:
dropsy N: ~dropsies
dross N: ~drosses
drought N: droughts
drouth N: drouths
drove N: droves
-drove V: droved  droving  droves
drover N: drovers
drown V: drowned  drowning  drowns
drowning N: drownings
drowse N: drowses
drowse V: drowsed  drowsing  drowses
drowsily A:
drowsiness N: ~drowsinesses
drowsy A: drowsier  drowsiest
-drub N: drubs
drub V: drubbed  drubbing  drubs
drubber N: drubbers
drubbing N: drubbings
drudge N: drudges
drudge V: drudged  drudging  drudges
drudgery N: ~drudgeries
drug N: drugs
drug V: drugged  drugging  drugs
-druggie A: druggier  druggiest
druggie N: druggies
druggist N: druggists
-druggy A: druggier  druggiest
druggy N: druggies
drugstore N: drugstores
druid N: druids
druidism N: ~druidisms
drum N: drums
drum V: drummed  drumming  drums
drumbeat N: drumbeats
drumlin N: drumlins
drummer N: drummers
drumstick N: drumsticks
drunk A: drunker  drunkest
drunk N: drunks
drunkard N: drunkards
drunken A:
drunkenly A:
drunkenness N: ~drunkennesses
drupe N: drupes
druthers N:
dry A: drier (-dryer)  driest (-dryest)
dry N: drys (dries)
dry V: dried  drying  dries
dryad N: dryads (-dryades)
dryer N: dryers
dryly A:
dryness N: ~drynesses
drywall N: ~drywalls
dual A:
-dual N: duals
dualism N: ~dualisms
duality N: ~dualities
dub N: dubs
dub V: dubbed  dubbing  dubs
dubber N: dubbers
dubbin N: ~dubbins
dubiety N: ~dubieties
dubious A:
dubiously A:
dubiousness N: ~dubiousnesses
ducal A:
ducat N: ducats
duchess N: duchesses
duchy N: duchies
duck N: ducks | duck
duck V: ducked  ducking  ducks
duckbill N: duckbills
duckling N: ducklings
duckpins N:
duckweed N: ~duckweeds
ducky A: duckier  duckiest
ducky N: duckies
duct N: ducts
-duct V: ducted  ducting  ducts
ductile A:
ductility N: ~ductilities
ductless A:
dud A:
dud N: duds
dude N: dudes
dude V: duded  duding  dudes
dudgeon N: ~dudgeons
due A:
due N: dues
duel N: duels
duel V: dueled (duelled)  dueling (duelling)  duels
dueler N: duelers
duelist N: duelists
duellist N: duellists
duenna N: duennas
duet N: duets
-duet V: duetted  duetting  duets
duff A:
duff N: duffs
-duff V: duffed  duffing  duffs
duffer N: duffers
-dug N: dugs
dugout N: dugouts
duh I:
duke N: dukes
dukedom N: dukedoms
dulcet A:
-dulcet N: dulcets
dulcimer N: dulcimers
dull A: duller  dullest
dull V: dulled  dulling  dulls
dullard N: dullards
dullness N: ~dullnesses
dully A:
dulness N: ~dulnesses
duly A:
dumb A: dumber  dumbest
dumbbell N: dumbbells
dumbfound V: dumbfounded  dumbfounding  dumbfounds
dumbly A:
dumbness N: ~dumbnesses
dumbstruck A:
dumbwaiter N: dumbwaiters
dumdum N: dumdums
dumfound V: dumfounded  dumfounding  dumfounds
dummy A: -dummier  -dummiest
dummy N: dummies
-dummy V: dummied  dummying  dummies
dump N: dumps
dump V: dumped  dumping  dumps
dumpiness N: ~dumpinesses
dumpling N: dumplings
dumpster N: dumpsters
dumpy A: dumpier  dumpiest
dun A: dunner  dunnest
dun N: ~duns
dun V: dunned  dunning  duns
dunce N: dunces
dunderhead N: dunderheads
dune N: dunes
dung N: ~dungs
dung V: dunged  dunging  dungs
dungaree N: dungarees
dungeon N: dungeons
dunghill N: dunghills
dunk N: dunks
dunk V: dunked  dunking  dunks
dunno S:
duo N: duos
duodecimal A:
-duodecimal N: duodecimals
duodenal A:
duodenum N: duodena (duodenums)
dupe N: dupes
dupe V: duped  duping  dupes
duper N: dupers
duple A:
duplex A:
duplex N: duplexes
-duplex V: duplexed  duplexing  duplexes
duplicate A:
duplicate N: duplicates
duplicate V: duplicated  duplicating  duplicates
duplication N: ~duplications
duplicator N: duplicators
duplicitous A:
duplicity N: ~duplicities
durability N: ~durabilities
durable A:
-durable N: durables
durably A:
durance N: ~durances
duration N: ~durations
duress N: ~duresses
during C:
durum N: ~durums
-dusk A: -dusker  -duskest
dusk N: ~dusks
-dusk V: dusked  dusking  dusks
duskiness N: ~duskinesses
dusky A: duskier  duskiest
dust N: ~dusts
dust V: dusted  dusting  dusts
duster N: dusters
dustiness N: ~dustinesses
dustless A:
dustpan N: dustpans
dusty A: dustier  dustiest
dutch A:
duteous A:
duteously A:
dutiable A:
dutiful A:
dutifully A:
dutifulness N: ~dutifulnesses
duty N: duties
duvet N: duvets
dwarf A: -dwarfer  -dwarfest
dwarf N: dwarfs (dwarves)
dwarf V: dwarfed  dwarfing  dwarfs
dwarfish A:
dwarfism N: ~dwarfisms
dweeb N: dweebs
-dwell N: dwells
dwell V: dwelt (dwelled)  dwelling  dwells
dweller N: dwellers
dwelling N: dwellings
dwindle V: dwindled  dwindling  dwindles
dybbuk N: dybbukim / dybbuks
dye N: dyes
dye V: dyed  dyeing  dyes
dyer N: dyers
dyestuff N: ~dyestuffs
dying N: ~dyings
dyke N: dykes
-dyke V: dyked  dyking  dykes
dynamic A:
dynamic N: dynamics
dynamical A:
dynamically A:
dynamics N:
dynamism N: ~dynamisms
dynamite A:
dynamite N: ~dynamites
dynamite V: dynamited  dynamiting  dynamites
dynamiter N: dynamiters
dynamo N: dynamos
dynastic A:
dynasty N: dynasties
dysentery N: ~dysenteries
dysfunction N: dysfunctions
dysfunctional A:
dyslectic A:
dyslectic N: dyslectics
dyslexia N: ~dyslexias
dyslexic A:
dyslexic N: dyslexics
dyspepsia N: ~dyspepsias
dyspeptic A:
dyspeptic N: dyspeptics
dysprosium N: ~dysprosiums
