wackiness N: ~wackinesses
wacko A:
wacko N: wackos
wacky A: wackier  wackiest
wad N: wads
wad V: wadded  wadding  wads
wadding N: ~waddings
waddle N: waddles
waddle V: waddled  waddling  waddles
wade N: wades
wade V: waded  wading  wades
wader N: waders
waders N:
wadi N: wadis
wafer N: wafers
-wafer V: wafered  wafering  wafers
waffle N: waffles
waffle V: waffled  waffling  waffles
waffler N: wafflers
waft N: wafts
waft V: wafted  wafting  wafts
wag N: wags
wag V: wagged  wagging  wags
wage N: wages
wage V: waged  waging  wages
wager N: wagers
wager V: wagered  wagering  wagers
wagerer N: wagerers
waggery N: waggeries
waggish A:
waggishly A:
waggishness N: ~waggishnesses
waggle N: waggles
waggle V: waggled  waggling  waggles
waggon N: waggons
-waggon V: waggoned  waggoning  waggons
wagon N: wagons
-wagon V: wagoned  wagoning  wagons
wagoner N: wagoners
wagtail N: wagtails
waif N: waifs
wail N: wails
wail V: wailed  wailing  wails
wailer N: wailers
wailing N: ~wailings
wain N: wains
wainscot N: wainscots
wainscot V: wainscoted (wainscotted)  wainscoting (wainscotting)  wainscots
wainscoting N: wainscotings
wainscotting N: wainscottings
wainwright N: wainwrights
waist N: waists
waistband N: waistbands
waistcoat N: waistcoats
waistline N: waistlines
wait N: waits
wait V: waited  waiting  waits
waiter N: waiters
-waiter V: waitered  waitering  waiters
waiting N: ~waitings
waitperson N: waitpersons (-waitpeople)
waitress N: waitresses
-waitress V: waitressed  waitressing  waitresses
waitstaff N: ~waitstaffs
waive V: waived  waiving  waives
waiver N: waivers
wake N: wakes
wake V: woke / waked  waked (woken woke)  waking  wakes
wakeful A:
wakefully A:
wakefulness N: ~wakefulnesses
waken V: wakened  wakening  wakens
wale N: ~wales
wale V: waled  waling  wales
walk N: walks
walk V: walked  walking  walks
walkaway N: walkaways
walker N: walkers
walking N: ~walkings
walkout N: walkouts
walkover N: walkovers
walkway N: walkways
wall N: walls
wall V: walled  walling  walls
wallaby N: wallabies | wallaby
wallboard N: ~wallboards
wallet N: wallets
walleye N: walleye | walleyes
walleyed A:
wallflower N: wallflowers
wallop N: wallops
wallop V: walloped  walloping  wallops
walloping N: wallopings
wallow N: wallows
wallow V: wallowed  wallowing  wallows
wallpaper N: wallpapers
wallpaper V: wallpapered  wallpapering  wallpapers
walnut N: walnuts
walrus N: walruses | walrus
waltz N: waltzes
waltz V: waltzed  waltzing  waltzes
waltzer N: waltzers
wampum N: ~wampums
wan A: wanner  wannest
-wan V: wanned  wanning  wans
wand N: wands
-wander N: wanders
wander V: wandered  wandering  wanders
wanderer N: wanderers
wanderings N:
wanderlust N: wanderlusts
wane N: wanes
wane V: waned  waning  wanes
wangle N: wangles
wangle V: wangled  wangling  wangles
wangler N: wanglers
wanly A:
wanna S:
wannabe A:
wannabe N: wannabes
wanness N: ~wannesses
want N: wants
want V: wanted  wanting  wants
wanton A: -wantoner  -wantonest
wanton N: wantons
wanton V: wantoned  wantoning  wantons
wantonly A:
wantonness N: ~wantonnesses
wapiti N: wapitis | wapiti
war A:
war N: wars
war V: warred  warring  wars
warble N: warbles
warble V: warbled  warbling  warbles
warbler N: warblers
warbonnet N: warbonnets
ward N: wards
ward V: warded  warding  wards
warden N: wardens
warder N: warders
wardrobe N: wardrobes
-wardrobe V: wardrobed  wardrobing  wardrobes
wardroom N: wardrooms
-ware A:
ware N: wares
-ware V: wared  waring  wares
warehouse N: warehouses
warehouse V: warehoused  warehousing  warehouses
warfare N: ~warfares
warhead N: warheads
warhorse N: warhorses
warily A:
wariness N: ~warinesses
warlike A:
warlock N: warlocks
warlord N: warlords
warm A: warmer  warmest
-warm N: warms
warm V: warmed  warming  warms
warmblooded A:
warmer N: warmers
warmhearted A:
warmheartedness N: ~warmheartednesses
warmish A:
warmly A:
warmness N: ~warmnesses
warmonger N: warmongers
warmongering N: ~warmongerings
warmth N: ~warmths
warmup N: warmups
warn V: warned  warning  warns
warning N: warnings
warp N: warps
warp V: warped  warping  warps
warpath N: warpaths
warplane N: warplanes
warrant N: warrants
warrant V: warranted  warranting  warrants
warranty N: warranties
warranty V: warrantied  warrantying  warranties
warren N: warrens
warrior N: warriors
warship N: warships
wart N: warts
warthog N: warthogs
wartime A:
wartime N: ~wartimes
warty A: wartier  wartiest
wary A: warier  wariest
was V:
wash N: washes
wash V: washed  washing  washes
washable A:
washable N: washables
washbasin N: washbasins
washboard N: washboards
washbowl N: washbowls
washcloth N: washcloths
washer N: washers
washerwoman N: washerwomen
washing N: ~washings
washout N: washouts
washrag N: washrags
washroom N: washrooms
washstand N: washstands
washtub N: washtubs
washy A: washier  washiest
wasp N: wasps
waspish A:
waspishly A:
waspishness N: ~waspishnesses
wassail N: ~wassails
wassail V: wassailed  wassailing  wassails
wastage N: ~wastages
waste A:
waste N: wastes
waste V: wasted  wasting  wastes
wastebasket N: wastebaskets
wasteful A:
wastefully A:
wastefulness N: ~wastefulnesses
wasteland N: wastelands
wastepaper N: ~wastepapers
waster N: wasters
wastrel N: wastrels
watch N: watches
watch V: watched  watching  watches
watchband N: watchbands
watchdog N: watchdogs
-watchdog V: watchdogged  watchdogging  watchdogs
watcher N: watchers
watchful A:
watchfully A:
watchfulness N: ~watchfulnesses
watchmaker N: watchmakers
watchmaking N: ~watchmakings
watchman N: watchmen
watchtower N: watchtowers
watchword N: watchwords
water N: ~waters
water V: watered  watering  waters
waterbed N: waterbeds
waterbird N: waterbirds
waterborne A:
watercolor A:
watercolor N: watercolors
watercourse N: watercourses
watercraft N: watercraft
watercress N: ~watercresses
waterfall N: waterfalls
waterfowl N: waterfowl | waterfowls
waterfront N: waterfronts
waterhole N: waterholes
wateriness N: ~waterinesses
waterlily N: waterlilies
waterline N: waterlines
waterlogged A:
watermark N: watermarks
watermark V: watermarked  watermarking  watermarks
watermelon N: watermelons
watermill N: watermills
waterpower N: ~waterpowers
waterproof A:
waterproof N: waterproofs
waterproof V: waterproofed  waterproofing  waterproofs
waterproofing N: ~waterproofings
waters N:
watershed N: watersheds
waterside A:
waterside N: watersides
waterspout N: waterspouts
watertight A:
waterway N: waterways
waterwheel N: waterwheels
waterworks N:
watery A: waterier  wateriest
watt N: watts
wattage N: ~wattages
-wattle A:
wattle N: wattles
wattle V: wattled  wattling  wattles
wave N: waves
wave V: waved  waving  waves
wavelength N: wavelengths
wavelet N: wavelets
wavelike A:
waver N: wavers
waver V: wavered  wavering  wavers
waverer N: waverers
waveringly A:
waviness N: ~wavinesses
wavy A: wavier  waviest
-wavy N: wavies
wax A:
wax N: ~waxes
wax V {increase}: waxed  waxed (-waxen)  waxing  waxes
wax V {polish}: waxed  waxing  waxes
waxen A:
waxiness N: ~waxinesses
waxwing N: waxwings
waxwork N: waxworks
waxy A: waxier  waxiest
way A:
way N: ways
waybill N: waybills
wayfarer N: wayfarers
wayfaring A:
wayfaring N: wayfarings
waylay V: waylaid  waylaying  waylays
waylayer N: waylayers
wayside N: waysides
wayward A:
waywardly A:
waywardness N: ~waywardnesses
we P:
weak A: weaker  weakest
weaken V: weakened  weakening  weakens
weakener N: weakeners
weakfish N: weakfish | weakfishes
weakling N: weaklings
weakly A: ~weaklier  ~weakliest
weakness N: weaknesses
weal N: weals
wealth N: ~wealths
wealthiness N: ~wealthinesses
wealthy A: wealthier  wealthiest
wean V: weaned  weaning  weans
weapon N: weapons
-weapon V: weaponed  weaponing  weapons
weaponless A:
weaponry N: ~weaponries
wear N: ~wears
wear V: wore  worn  wearing  wears
wearable A:
-wearable N: wearables
wearer N: wearers
wearily A:
weariness N: ~wearinesses
wearisome A:
wearisomely A:
weary A: wearier  weariest
weary V: wearied  wearying  wearies
weasel N: weasels | weasel
weasel V: weaseled (weaselled)  weaseling (weaselling)  weasels
weaselly A:
weather A:
weather N: ~weathers
weather V: weathered  weathering  weathers
weathercock N: weathercocks
weathering N: ~weatherings
weatherization N: ~weatherizations
weatherize V: weatherized  weatherizing  weatherizes
weatherman N: weathermen
weatherperson N: weatherpersons
weatherproof A:
weatherproof V: weatherproofed  weatherproofing  weatherproofs
weatherstrip V: weatherstripped  weatherstripping  weatherstrips
weatherstripping N: ~weatherstrippings
weave N: weaves
weave V {fabric}: wove  woven  weaving  weaves
weave V {zigzag}: weaved  weaving  weaves
weaver N: weavers
weaving N: ~weavings
web N: webs
web V: webbed  webbing  webs
webbing N: ~webbings
webfoot N: webfeet
website N: websites
wed V: wedded (wed)  wedding  weds
wedding N: weddings
wedge N: wedges
wedge V: wedged  wedging  wedges
wedgie N: wedgies
wedlock N: ~wedlocks
wee A: weer  weest
wee N: ~wees
wee V: weed  weeing  wees
weed N: weeds
weed V: weeded  weeding  weeds
weeder N: weeders
weedless A:
weedy A: weedier  weediest
-week A:
week N: weeks
weekday A:
weekday N: weekdays
weekend N: weekends
weekend V: weekended  weekending  weekends
weekly A:
weekly N: weeklies
weeknight N: weeknights
ween V: weened  weening  weens
weenie N: weenies
weensy A: weensier  weensiest
weeny A: weenier  weeniest
-weeny N: weenies
weep N: weeps
weep V: wept  weeping  weeps
weeper N: weepers
weepy A: weepier  weepiest
weepy N: weepies
weevil N: weevils
weft N: wefts
weigh N: ~weighs
weigh V: weighed  weighing  weighs
weight N: weights
weight V: weighted  weighting  weights
weightily A:
weightiness N: ~weightinesses
weightless A:
weightlessly A:
weightlessness N: ~weightlessnesses
weightlifter N: weightlifters
weightlifting N: ~weightliftings
weighty A: weightier  weightiest
weir N: weirs
weird A: weirder  weirdest
-weird N: weirds
weirdie N: weirdies
weirdly A:
weirdness N: ~weirdnesses
weirdo N: weirdos
welch V: welched  welching  welches
welcome A:
welcome I:
welcome N: welcomes
welcome V: welcomed  welcoming  welcomes
weld N: welds
weld V: welded  welding  welds
weldable A:
welder N: welders
welfare N: ~welfares
welkin N: ~welkins
well A: better  best
well I:
well N: wells
well V: welled  welling  wells
wellhead N: wellheads
wellington N: wellingtons
wellness N: ~wellnesses
wellspring N: wellsprings
welsh V: welshed  welshing  welshes
welsher N: welshers
welt N: welts
welt V: welted  welting  welts
welter N: welters
welter V: weltered  weltering  welters
welterweight N: welterweights
wen N: wens
wench N: wenches
-wench V: wenched  wenching  wenches
wend V: wended (-@went)  wending  wends
went V:
were V:
werewolf N: werewolves
werwolf N: werwolves
west A:
west N: ~wests
westbound A:
westerly A:
westerly N: westerlies
western A:
western N: westerns
westerner N: westerners
westernization N: ~westernizations
westernize V: westernized  westernizing  westernizes
westernmost A:
westward A:
-westward N: westwards
westwards A:
wet A: wetter  wettest
wet N: wets
wet V: wet (wetted)  wetting  wets
wetback N: wetbacks
wetland N: wetlands
wetly A:
wetness N: ~wetnesses
wetter N: wetters
whack N: whacks
whack V: whacked  whacking  whacks
whacker N: whackers
whacky A: whackier  whackiest
whale N: whales | whale
whale V: whaled  whaling  whales
whaleboat N: whaleboats
whalebone N: ~whalebones
whaler N: whalers
whaling N: ~whalings
-wham A:
wham I:
wham N: whams
wham V: whammed  whamming  whams
whammy N: whammies
wharf N: wharves (wharfs)
-wharf V: wharfed  wharfing  wharfs
what A:
what I:
what N: whats
what P:
whatchamacallit N: whatchamacallits
whatever A:
whatever P:
whatnot N: ~whatnots
whatsoever A:
whatsoever P:
wheal N: wheals
wheat N: ~wheats
wheaten A:
whee I:
wheedle V: wheedled  wheedling  wheedles
wheedler N: wheedlers
wheel N: wheels
wheel V: wheeled  wheeling  wheels
wheelbarrow N: wheelbarrows
-wheelbarrow V: wheelbarrowed  wheelbarrowing  wheelbarrows
wheelbase N: wheelbases
wheelchair N: wheelchairs
wheelhouse N: wheelhouses
wheelie N: wheelies
wheelwright N: wheelwrights
wheeze N: wheezes
wheeze V: wheezed  wheezing  wheezes
wheezily A:
wheeziness N: ~wheezinesses
wheezy A: wheezier  wheeziest
whelk N: whelks
whelm V: whelmed  whelming  whelms
whelp N: whelps
whelp V: whelped  whelping  whelps
when A:
when C:
when N: whens
when P:
whence A:
whence C:
whenever A:
whenever C:
whensoever A:
whensoever C:
where A:
where C:
where N: wheres
whereabouts A:
whereabouts N: whereabouts
whereas C:
-whereas N: whereases
whereat A:
whereby A:
wherefore A:
wherefore N: wherefores
wherein A:
whereof A:
whereon A:
wheresoever C:
whereto C:
whereupon C:
wherever A:
wherever C:
wherewith C:
-wherewith N: wherewiths
wherewithal N: ~wherewithals
wherry N: wherries
-wherry V: wherried  wherrying  wherries
-whet N: whets
whet V: whetted  whetting  whets
whether C:
whetstone N: whetstones
whew I:
-whew N: whews
whey N: ~wheys
which A:
which P:
whichever A:
whichever P:
whiff N: whiffs
whiff V: whiffed  whiffing  whiffs
whiffletree N: whiffletrees
while C:
while N: whiles
while V: whiled  whiling  whiles
whilom A:
whilst C:
whim N: whims
whimper N: whimpers
whimper V: whimpered  whimpering  whimpers
whimsey N: whimseys
whimsical A:
whimsicality N: ~whimsicalities
whimsically A:
whimsy N: whimsies
whine N: whines
whine V: whined  whining  whines
whiner N: whiners
whinny N: whinnies
whinny V: whinnied  whinnying  whinnies
whiny A: whinier  whiniest
whip N: whips
whip V: whipped  whipping  whips
whipcord N: ~whipcords
whiplash N: whiplashes
-whiplash V: whiplashed  whiplashing  whiplashes
whipper N: whippers
whippersnapper N: whippersnappers
whippet N: whippets
whipping N: whippings
whippletree N: whippletrees
whippoorwill N: whippoorwills
whipsaw N: whipsaws
whipsaw V: whipsawed  whipsawed (whipsawn)  whipsawing  whipsaws
whir N: whirs
whir V: whirred  whirring  whirs
whirl N: whirls
whirl V: whirled  whirling  whirls
whirligig N: whirligigs
whirlpool N: whirlpools
whirlwind A:
whirlwind N: whirlwinds
whirlybird N: whirlybirds
whirr N: whirrs
whirr V: whirred  whirring  whirrs
whisk N: whisks
whisk V: whisked  whisking  whisks
whisker N: whiskers
whiskered A:
whiskery A:
whiskey N: whiskeys
whisky N: whiskies
whisper N: whispers
whisper V: whispered  whispering  whispers
whisperer N: whisperers
-whist A:
whist N: ~whists
-whist V: whisted  whisting  whists
whistle N: whistles
whistle V: whistled  whistling  whistles
whistler N: whistlers
whit N: whits
white A: whiter  whitest
white N: whites
-white V: whited  whiting  whites
whitecap N: whitecaps
whitefish N: whitefish | whitefishes
whitehead N: whiteheads
whiten V: whitened  whitening  whitens
whitener N: whiteners
whiteness N: ~whitenesses
whitening N: whitenings
whiteout N: whiteouts
whitetail N: whitetails
whitewall N: whitewalls
whitewash N: whitewashes
whitewash V: whitewashed  whitewashing  whitewashes
whitewater N: ~whitewaters
whitey N: whiteys
whither A:
whither C:
whiting N {chalk}: ~whitings
whiting N {fish}: whiting | whitings
whitish A:
-whittle N: whittles
whittle V: whittled  whittling  whittles
whittler N: whittlers
whiz N: whizzes
whiz V: whizzed  whizzing  whizzes
whizkid N: whizkids
whizz N: whizzes
whizz V: whizzed  whizzing  whizzes
whizzbang N: whizzbangs
who P:
whoa I:
whoa V:
whodunit N: whodunits
whodunnit N: whodunnits
whoever P:
whole A:
whole N: wholes
wholehearted A:
wholeheartedly A:
wholeheartedness N: ~wholeheartednesses
wholeness N: ~wholenesses
wholesale A:
wholesale N: ~wholesales
wholesale V: wholesaled  wholesaling  wholesales
wholesaler N: wholesalers
wholesome A: wholesomer  wholesomest
wholesomely A:
wholesomeness N: ~wholesomenesses
wholly A:
whom P:
whomever P:
whomsoever P:
whoop N: whoops
whoop V: whooped  whooping  whoops
whoopee I:
whooper N: whoopers
whoops I:
whoosh N: whooshes
whoosh V: whooshed  whooshing  whooshes
whopper N: whoppers
whopping A:
whore N: whores
-whore V: whored  whoring  whores
whorehouse N: whorehouses
whoreish A:
whorish A:
whorl N: whorls
whorled A:
whose A:
whose P:
whoso P:
whosoever P:
why A:
why C:
why I:
why N: whys
wick N: wicks
-wick V: wicked  wicking  wicks
wicked A: wickeder  wickedest
wickedly A:
wickedness N: ~wickednesses
wicker A:
wicker N: wickers
wickerwork N: ~wickerworks
wicket N: wickets
wide A: wider  widest
-wide N: wides
widely A:
widemouthed A:
widen V: widened  widening  widens
widener N: wideners
wideness N: ~widenesses
widespread A:
widgeon N: widgeons | widgeon
widow N: widows
widow V: widowed  widowing  widows
widowed A:
widower N: widowers
widowhood N: ~widowhoods
width N: widths
wield V: wielded  wielding  wields
wielder N: wielders
wiener N: wieners
wienie N: wienies
wife N: wives
-wife V: wifed  wifing  wifes
wifeless A:
wifely A: !wifelier  !wifeliest
wig N: wigs
wig V: wigged  wigging  wigs
wigeon N: wigeons | wigeon
wiggle N: wiggles
wiggle V: wiggled  wiggling  wiggles
wiggler N: wigglers
wiggly A: wigglier  wiggliest
wight N: wights
wiglet N: wiglets
wigwag N: wigwags
wigwag V: wigwagged  wigwagging  wigwags
wigwam N: wigwams
wild A: wilder  wildest
wild N: wilds
wildcat A:
wildcat N: wildcats | wildcat
wildcat V: wildcatted  wildcatting  wildcats
wildcatter N: wildcatters
wildebeest N: wildebeests | wildebeest
wilderness N: wildernesses
wildfire N: wildfires
wildflower N: wildflowers
wildfowl N: wildfowl (wildfowls)
wildlife N: ~wildlifes
wildly A:
wildness N: ~wildnesses
wilds N:
wile N: wiles
wile V: wiled  wiling  wiles
wilful A:
wilfully A:
wilfulness N: ~wilfulnesses
wiliness N: ~wilinesses
will N: wills
will V {future}: would (@wouldst)  -  will (@wilt)
will V: willed  willing  wills
willful A:
willfully A:
willfulness N: ~willfulnesses
willies N:
willing A: -willinger  -willingest
willingly A:
willingness N: ~willingnesses
williwaw N: williwaws
willow N: willows
-willow V: willowed  willowing  willows
willowy A: !willowier  !willowiest
willpower N: ~willpowers
wilt N: ~wilts
wilt V: wilted  wilting  wilts
wily A: wilier  wiliest
wimp N: wimps
wimpish A:
wimple N: wimples
wimple V: wimpled  wimpling  wimples
wimpy A: wimpier  wimpiest
win N: wins
win V: won  winning  wins
wince N: winces
wince V: winced  wincing  winces
winch N: winches
winch V: winched  winching  winches
wind N: winds
wind V {blow}: winded (wound)  winding  winds
wind V {curve}: wound (winded)  winding  winds
wind V {scent, tire}: winded  winding  winds
windbag N: windbags
windblown A:
windbreak N: windbreaks
windbreaker N: windbreakers
windburn N: ~windburns
windburned A:
windchill N: ~windchills
winded A:
winder N: winders
windfall N: windfalls
windflower N: windflowers
windily A:
windiness N: ~windinesses
winding N: ~windings
windjammer N: windjammers
windlass N: windlasses
-windlass V: windlassed  windlassing  windlasses
windless A:
windmill N: windmills
windmill V: windmilled  windmilling  windmills
window N: windows
-window V: windowed  windowing  windows
windowless A:
windowpane N: windowpanes
windowsill N: windowsills
windpipe N: windpipes
windproof A:
windrow N: windrows
-windrow V: windrowed  windrowing  windrows
windshield N: windshields
windsock N: windsocks
windstorm N: windstorms
windsurf V: windsurfed  windsurfing  windsurfs
windsurfer N: windsurfers
windsurfing N: ~windsurfings
windswept A:
windup A:
windup N: windups
windward A:
windward N: ~windwards
windy A: windier  windiest
wine N: wines
wine V: wined  wining  wines
wineglass N: wineglasses
winegrower N: winegrowers
winemaker N: winemakers
winery N: wineries
wing N: wings
wing V: winged  winging  wings
wingding N: wingdings
wingless A:
winglike A:
wingspan N: wingspans
wingspread N: wingspreads
wingtip N: wingtips
wink N: winks
wink V: winked  winking  winks
winker N: winkers
winkle N: winkles
winkle V: winkled  winkling  winkles
winnable A:
winner N: winners
winning A: -  winningest
winning N: winnings
winningly A:
-winnow N: winnows
winnow V: winnowed  winnowing  winnows
winnower N: winnowers
wino N: winos
winsome A: winsomer  winsomest
winsomely A:
winsomeness N: ~winsomenesses
winter A:
winter N: winters
winter V: wintered  wintering  winters
wintergreen N: ~wintergreens
winterize V: winterized  winterizing  winterizes
wintertime N: ~wintertimes
wintery A: winterier  winteriest
wintry A: wintrier  wintriest
winy A: winier  winiest
wipe N: wipes
wipe V: wiped  wiping  wipes
wiper N: wipers
wire A:
wire N: wires
wire V: wired  wiring  wires
wirehair N: wirehairs
wireless A:
wireless N: wirelesses
-wireless V: wirelessed  wirelessing  wirelesses
wiretap N: wiretaps
wiretap V: wiretapped  wiretapping  wiretaps
wiretapper N: wiretappers
wiretapping N: ~wiretappings
wiriness N: ~wirinesses
wiring N: ~wirings
wiry A: wirier  wiriest
wisdom N: ~wisdoms
wise A: wiser  wisest
wise N: wises
-wise V: wised  wising  wises
wiseacre N: wiseacres
wisecrack N: wisecracks
wisecrack V: wisecracked  wisecracking  wisecracks
wisely A: -wiselier  -wiseliest
wish N: wishes
wish V: wished  wishing  wishes
wishbone N: wishbones
wisher N: wishers
wishful A:
wishfully A:
wisp N: wisps
-wisp V: wisped  wisping  wisps
wispy A: wispier  wispiest
wistaria N: wistarias
wisteria N: wisterias
wistful A:
wistfully A:
wistfulness N: ~wistfulnesses
wit A:
wit N: wits
@wit V: wist  witting  wot  -wost  -wit / -wite
witch N: witches
witch V: witched  witching  witches
witchcraft N: ~witchcrafts
witchery N: ~witcheries
with C:
withal A:
withdraw V: withdrew  withdrawn  withdrawing  withdraws
withdrawal N: withdrawals
withe N: withes
withe V: withed  withing  withes
wither V: withered  withering  withers
witheringly A:
withers N:
withhold V: withheld  withholding  withholds
withholding N: ~withholdings
within A:
within C:
within N: ~withins
without A:
without C:
-without N: withouts
withstand V: withstood  withstanding  withstands
witless A:
witlessly A:
witlessness N: ~witlessnesses
witness N: witnesses
witness V: witnessed  witnessing  witnesses
wits N:
witted A:
witticism N: witticisms
wittily A:
wittiness N: ~wittinesses
-witting N: wittings
wittingly A:
witty A: wittier  wittiest
wive V: wived  wiving  wives
wiz N: wizzes / wizes
-wizard A:
wizard N: wizards
wizardry N: ~wizardries
wizened A:
woad N: ~woads
wobble N: wobbles
wobble V: wobbled  wobbling  wobbles
wobbliness N: ~wobblinesses
wobbly A: wobblier  wobbliest
woe N: woes
woebegone A:
woeful A: woefuller  woefullest
woefully A:
woefulness N: ~woefulnesses
wok N: woks
wold N: wolds
wolf N: wolves (wolf)
wolf V: wolfed  wolfing  wolfs
wolfhound N: wolfhounds
wolfish A:
wolfram N: ~wolframs
wolverine N: wolverines (wolverine)
woman A:
woman N: women
-woman V: womaned  womaning  womans
womanhood N: ~womanhoods
womanish A:
womanize V: womanized  womanizing  womanizes
womanizer N: womanizers
womankind N:
womanlike N:
womanliness N: ~womanlinesses
womanly A: womanlier  womanliest
womb N: wombs
wombat N: wombats
womenfolk N:
womenfolks N:
won N: won
-won V: wonned  wonning  wons
wonder A:
wonder N: wonders
wonder V: wondered  wondering  wonders
wonderful A:
wonderfully A:
wonderfulness N: ~wonderfulnesses
wonderingly A:
wonderland N: wonderlands
wonderment N: ~wonderments
wondrous A:
wondrously A:
wonk N: wonks
wonky A: wonkier  wonkiest
wont A:
wont N: ~wonts
-wont V: wonted  wonting  wonts
wonted A:
wonton N: wontons
woo V: wooed  wooing  woos
wood A:
wood N: woods
wood V: wooded  wooding  woods
woodbine N: ~woodbines
woodblock N: woodblocks
woodcarver N: woodcarvers
woodcarving N: woodcarvings
woodchuck N: woodchucks
woodcock N: woodcocks
woodcraft N: ~woodcrafts
woodcut N: woodcuts
woodcutter N: woodcutters
woodcutting N: ~woodcuttings
wooded A:
wooden A: woodener  woodenest
woodenly A:
woodenness N: ~woodennesses
woodiness N: ~woodinesses
woodland N: woodlands
woodlot N: woodlots
woodman N: woodmen
woodpecker N: woodpeckers
woodpile N: woodpiles
woods N:
woodshed N: woodsheds
-woodshed V: woodshedded  woodshedding  woodsheds
woodsiness N: ~woodsinesses
woodsman N: woodsmen
woodsy A: woodsier  woodsiest
woodwind A:
woodwind N: woodwinds
woodwork N: ~woodworks
woodworker N: woodworkers
woodworking N: ~woodworkings
woody A: woodier  woodiest
woody N: woodies
wooer N: wooers
woof N: woofs
woof V: woofed  woofing  woofs
woofer N: woofers
wool N: ~wools
woolen A:
woolen N: woolens
woolgathering N: ~woolgatherings
woolie N: woolies
woollen A:
woollen N: woollens
woolliness N: ~woollinesses
woolly A: woollier  woolliest
woolly N: woollies
wooly A: woolier  wooliest
wooly N: woolies
woozily A:
wooziness N: ~woozinesses
woozy A: woozier  wooziest
word N: words
word V: worded  wording  words
wordage N: ~wordages
wordbook N: wordbooks
wordily A:
wordiness N: ~wordinesses
wording N: wordings
wordless A:
wordlessly A:
wordplay N: ~wordplays
wordy A: wordier  wordiest
work A:
work N: works
work V: worked (wrought)  working  works
workable A:
workaday A:
workaholic N: workaholics
workbench N: workbenches
workbook N: workbooks
-workday A:
workday N: workdays
worker N: workers
workfare N: ~workfares
workforce N: ~workforces
workhorse N: workhorses
workhouse N: workhouses
working A:
working N: workings
workingman N: workingmen
workings N:
workingwoman N: workingwomen
workload N: workloads
workman N: workmen
workmanlike A:
workmanship N: ~workmanships
workout N: workouts
workplace N: workplaces
workroom N: workrooms
works N:
worksheet N: worksheets
workshop N: workshops
workstation N: workstations
worktable N: worktables
workup N: workups
workweek N: workweeks
world A:
world N: worlds
worldliness N: ~worldlinesses
worldly A: worldlier  worldliest
worldview N: worldviews
worldwide A:
worm N: worms
worm V: wormed  worming  worms
wormhole N: wormholes
wormwood N: ~wormwoods
wormy A: wormier  wormiest
worrier N: worriers
worriment N: ~worriments
worrisome A:
worry N: worries
worry V: worried  worrying  worries
worrywart N: worrywarts
worse N: ~worses
worsen V: worsened  worsening  worsens
worship N: ~worships
worship V: worshiped (worshipped)  worshiping (worshipping)  worships
worshiper N: worshipers
worshipful A:
worshipper N: worshippers
worst N: ~worsts
worst V: worsted  worsting  worsts
worsted A:
worsted N: ~worsteds
wort N: ~worts
worth A:
worth C:
worth N: ~worths
-worth V: worthed  worthing  worths
worthily A:
worthiness N: ~worthinesses
worthless A:
worthlessly A:
worthlessness N: ~worthlessnesses
worthwhile A:
worthy A: worthier  worthiest
worthy N: worthies
wound N: wounds
wound V: wounded  wounding  wounds
wow I:
wow N: wows
wow V: wowed  wowing  wows
wrack N: ~wracks
-wrack V: wracked  wracking  wracks
wraith N: wraiths
wrangle N: wrangles
wrangle V: wrangled  wrangling  wrangles
wrangler N: wranglers
wrap A:
wrap N: wraps
wrap V: wrapped (wrapt)  wrapping  wraps
wraparound A:
wraparound N: wraparounds
wrapper N: wrappers
wrapping N: wrappings
wrasse N: wrasses
-wrath A:
wrath N: ~wraths
wrathful A:
wrathfully A:
wreak V: wreaked  wreaking  wreaks
wreath N: wreaths
-wreath V: wreathed  wreathing  wreaths
wreathe V: wreathed  wreathing  wreathes
wreck N: wrecks
wreck V: wrecked  wrecking  wrecks
wreckage N: ~wreckages
wrecker N: wreckers
wren N: wrens
wrench N: wrenches
wrench V: wrenched  wrenching  wrenches
wrest N: wrests
wrest V: wrested  wresting  wrests
wrestle N: wrestles
wrestle V: wrestled  wrestling  wrestles
wrestler N: wrestlers
wrestling N: ~wrestlings
wretch N: wretches
wretched A: wretcheder  wretchedest
wretchedly A:
wretchedness N: ~wretchednesses
wriggle N: wriggles
wriggle V: wriggled  wriggling  wriggles
wriggler N: wrigglers
wriggly A: !wrigglier  !wriggliest
wright N: wrights
wring N: wrings
wring V: wrung  wringing  wrings
wringer N: wringers
wrinkle N: wrinkles
wrinkle V: wrinkled  wrinkling  wrinkles
wrinkly A: wrinklier  wrinkliest
wrinkly N: wrinklies
wrist N: wrists
wristband N: wristbands
wristwatch N: wristwatches
writ N: writs
write V: wrote  written (writ)  writing  writes
writer N: writers
writhe N: writhes
writhe V: writhed  writhing  writhes
writing N: writings
wrong A: wronger  wrongest
wrong N: wrongs
wrong V: wronged  wronging  wrongs
wrongdoer N: wrongdoers
wrongdoing N: wrongdoings
wrongful A:
wrongfully A:
wrongfulness N: ~wrongfulnesses
wrongheaded A:
wrongheadedly A:
wrongheadedness N: ~wrongheadednesses
wrongly A:
wrongness N: ~wrongnesses
wroth A:
wrought A:
wry A: wryer (wrier)  wryest (wriest)
wryly A:
wryness N: ~wrynesses
wurst N: wursts
wuss N: wusses
wussy A: wussier  wussiest
wussy N: wussies
